K    United States of America
KAAA – Logan County  – Lincoln, Illinois
KAAF (AAF) – Apalachicola  – Apalachicola, Florida
KAAO – Colonel James Jabara  – Wichita, Kansas
KAAS – Taylor County  – Campbellsville, Kentucky
KAAT – Alturas  – Alturas, California
KABE (ABE) – Lehigh Valley Int'l  – Allentown, Bethlehem and Easton, Pennsylvania
KABI (ABI) – Abilene  – Abilene, Texas
KABQ (ABQ) – Albuquerque Int'l Sunport – Albuquerque, New Mexico
KABR (ABR) – Aberdeen  – Aberdeen, South Dakota
KABY (ABY) – Southwest Georgia  – Albany, Georgia
KACB (ACB) – Antrim County  – Bellaire, Michigan
KACJ – Jimmy Carter  (formerly Souther Field) – Americus, Georgia
KACK (ACK) – Nantucket Memorial  – Nantucket, Massachusetts
KACP – Allen Parish  – Oakdale, Louisiana
KACQ – Waseca  – Waseca, Minnesota
KACT (ACT) – Waco  – Waco, Texas
KACV (ACV) – Arcata-Eureka  – Arcata, California
KACY (ACY) – Atlantic City Int'l  – Atlantic City, New Jersey
KACZ – Henderson Field – Wallace, North Carolina
KADC – Wadena  – Wadena, Minnesota
KADG (ADG) – Lenawee County  – Adrian, Michigan
KADH (ADT) – Ada  – Ada, Oklahoma
KADM (ADM) – Ardmore  – Ardmore, Oklahoma
KADS (ADS) – Addison  – Addison, Texas
KADT – Atwood–Rawlins County City–County – Atwood, Kansas
KADU – Audubon County  – Audubon, Iowa
KADW (ADW) – Andrews Air Force Base – Camp Springs, Maryland
KAEG – Double Eagle II  – Albuquerque, New Mexico
KAEJ – Central Colorado  – Buena Vista, Colorado
KAEL (AEL) – Albert Lea  – Albert Lea, Minnesota
KAEX (AEX) – Alexandria Int'l  – Alexandria, Louisiana
KAFF (AFF) – United States Air Force Academy  – Colorado Springs, Colorado
KAFJ (WSG) – Washington County  – Washington, Pennsylvania
KAFK – Nebraska City  – Nebraska City, Nebraska
KAFN (AFN) – Jaffrey  – Silver Ranch Airpark – Jaffrey, New Hampshire
KAFO (AFO) – Afton  (Afton-Lincoln County ) – Afton, Wyoming
KAFP – Anson County  – Wadesboro, North Carolina
KAFW (AFW) – Fort Worth Alliance  – Fort Worth, Texas
KAGC (AGC) – Allegheny County  – West Mifflin, Pennsylvania
KAGO (AGO) – Magnolia  – Magnolia, Arkansas
KAGR – MacDill AFB Auxiliary Field – Avon Park, Florida
KAGS (AGS) – Augusta  at Bush Field – Augusta, Georgia
KAGZ – Wagner  – Wagner, South Dakota
KAHC (AHC) – Amedee Army  – Herlong, California
KAHH (AHH) – Amery  – Amery, Wisconsin
KAHN (AHN) – Athens Ben Epps  – Athens, Georgia
KAHQ – Wahoo  – Wahoo, Nebraska
KAIA (AIA) – Alliance  – Alliance, Nebraska
KAIB – Hopkins-Montrose County  – Nucla, Colorado
KAID (AID) – Anderson  (Darlington Field) – Anderson, Indiana
KAIG – Langlade County  – Antigo, Wisconsin
KAIK (AIK) – Aiken  – Aiken, South Carolina
KAIO (AIO) – Atlantic  – Atlantic, Iowa
KAIT – Aitkin  (Steve Kurtz Field) – Aitkin, Minnesota
KAIV (AIV) – George Downer  – Aliceville, Alabama
KAIY (AIY) – Atlantic City  (Bader Field) – Atlantic City, New Jersey (closed 2006)
KAIZ (AIZ) – Lee C. Fine Memorial  – Lake Ozark, Missouri
KAJG – Mount Carmel  – Mount Carmel, Illinois
KAJO – Corona  – Corona, California
KAJR – Habersham County  – Cornelia, Georgia
KAJZ – Blake Field – Delta, Colorado
KAKH – Gastonia  – Gastonia, North Carolina
KAKO (AKO) – Colorado Plains  – Akron, Colorado
KAKQ – Wakefield  – Wakefield, Virginia
KAKR (AKC) – Akron Fulton Int'l  – Akron, Ohio
KALB (ALB) – Albany Int'l  – Albany, New York
KALI (ALI) – Alice Int'l  – Alice, Texas
KALK - Airstrip west of Libby AAF See KFHU
KALM (ALM) – Alamogordo–White Sands – Alamogordo, New Mexico
KALN (ALN) – St. Louis  – Alton, Illinois
KALO (ALO) – Waterloo  – Waterloo, Iowa
KALS (ALS) – San Luis Valley  – Alamosa, Colorado
KALW (ALW) – Walla Walla  – Walla Walla, Washington
KALX (ALX) – Thomas C. Russell Field – Alexander City, Alabama
KAMA (AMA) – Rick Husband Amarillo Int'l – Amarillo, Texas
KAMG – Bacon County  – Alma, Georgia
KAMN (AMN) – Gratiot Community  – Alma, Michigan
KAMT – Alexander Salamon  – West Union, Ohio
KAMW (AMW) – Ames  – Ames, Iowa
KANB (ANB) – Anniston  – Anniston, Alabama
KAND (AND) – Anderson  – Anderson, South Carolina
KANE – Anoka County–Blaine  (Janes Field) – Minneapolis
KANJ – Sault Ste. Marie  (Sanderson Field) – Sault Ste. Marie, Michigan
KANK – Harriet Alexander Field – Salida, Colorado
KANP (ANP) – Lee  – Annapolis, Maryland
KANQ (ANQ) – Tri-State Steuben County  – Angola, Indiana
KANW (ANW) – Ainsworth  – Ainsworth, Nebraska
KANY (ANY) – Anthony  – Anthony, Kansas
KAOC – Arco Butte County  – Arco, Idaho
KAOH (AOH) – Lima Allen County  – Lima, Ohio
KAOO (AOO) – Altoona–Blair County  – Altoona, Pennsylvania
KAOV – Ava Bill Martin Memorial  – Ava, Missouri
KAPA (APA) – Centennial  – Centennial, Colorado
KAPC (APC) – Napa County  (Napa Valley ) – Napa, California
KAPF (APF) – Naples  – Naples, Florida
KAPG (APG) – Phillips Army  – Aberdeen Proving Ground, Maryland
KAPH (APH) – A.P. Hill Army  – Fort A.P. Hill, Virginia
KAPN (APN) – Alpena County  – Alpena, Michigan
KAPT (APT) – Marion County  (Brown Field) – Jasper, Tennessee
KAPV (APV) – Apple Valley  – Apple Valley, California
KAQO – Llano  – Llano, Texas
KAQP – Appleton  – Appleton, Minnesota
KAQR – Atoka  – Atoka, Oklahoma
KAQW – Harriman-and-West  – North Adams, Massachusetts
KARA (ARA) – Acadiana  – New Iberia, Louisiana
KARB (ARB) – Ann Arbor  – Ann Arbor, Michigan
KARG (ARG) – Walnut Ridge  – Walnut Ridge, Arkansas
KARM (WHT) – Wharton  – Wharton, Texas
KARR (AUZ) – Aurora  (Chicago/Aurora ) –A urora, Illinois
KART (ART) – Watertown Int'l  – Watertown, New York
KARV (ARV) – Lakeland  (Noble F. Lee Memorial Field) – Minocqua / Woodruff, Wisconsin
KARW (BFT) – Beaufort County  (Frogmore Island ) – Beaufort County, South Carolina
KASD – Slidell  – Slidell, Louisiana
KASE (ASE) – Aspen–Pitkin County  – Aspen, Colorado
KASG (SPZ) – Springdale  – Springdale, Arkansas
KASH (ASH) – Nashua  (Boire Field) – Nashua, New Hampshire
KASJ – Tri-County  – Ahoskie, North Carolina
KASL (ASL) – Harrison County  – Marshall, Texas
KASN (ASN) – Talladega  – Talladega, Alabama
KAST (AST) – Astoria  – Astoria, Oregon
KASW – Warsaw  – Warsaw, Indiana
KASX (ASX) – John F. Kennedy Memorial  – Ashland, Wisconsin
KASY (ASY) – Ashley  – Ashley, North Dakota
KATA – Hall–Miller  – Atlanta, Texas
KATL (ATL) – Hartsfield–Jackson Atlanta Int'l – Atlanta
KATS (ATS) – Artesia  – Artesia, New Mexico
KATW (ATW) – Appleton Int'l  – Greenville, Wisconsin (near Appleton)
KATY (ATY) – Watertown  – Watertown, South Dakota
KAUG (AUG) – Augusta State  – Augusta, Maine
KAUH – Aurora  (Al Potter Field) – Aurora, Nebraska
KAUM (AUM) – Austin  – Austin, Minnesota
KAUN (AUN) – Auburn  – Auburn, California
KAUO (AUO) – Auburn University  (Robert G. Pitts Field) – Auburn, Alabama
KAUS (AUS) – Austin–Bergstrom Int'l – Austin, Texas
KAUW (AUW) – Wausau Downtown  – Wausau, Wisconsin
KAVC – Mecklenburg-Brunswick – South Hill, Virginia
KAVK – Alva  – Alva, Oklahoma
KAVL (AVL) – Asheville  – Fletcher, North Carolina
KAVO (AVO) – Avon Park Executive  – Avon Park, Florida
KAVP (AVP) – Wilkes-Barre/Scranton Int'l – Avoca, Pennsylvania
KAVQ (AVW) – Marana  (Avra Valley ) – Marana, Arizona
KAVX (CIB) – Catalina  (Airport in the Sky) – Avalon / Santa Catalina Island, California
KAWG – Washington  – Washington, Iowa
KAWM (AWM) – West Memphis  – West Memphis, Arkansas
KAWO – Arlington  – Arlington, Washington
KAXA (AXG) – Algona  – Algona, Iowa
KAXH – Houston Southwest  – Arcola, Texas
KAXN (AXN) – Alexandria  (Chandler Field) – Alexandria, Minnesota
KAXQ – Clarion County  – Clarion, Pennsylvania
KAXS (AXS) – Altus/Quartz Mountain – Altus, Oklahoma
KAXV (AXV) – Neil Armstrong  (Auglaize County ) – Wapakoneta, Ohio
KAXX (AXX) – Angel Fire  – Angel Fire, New Mexico
KAYS (AYS) – Waycross–Ware County  – Waycross, Georgia
KAYX – Arnold Air Force Base – Tullahoma, Tennessee
KAZC – Colorado City  – Colorado City, Arizona
KAZE – Hazlehurst  – Hazlehurst, Georgia
KAZO (AZO) – Kalamazoo/Battle Creek Int'l – Kalamazoo / Battle Creek, Michigan
KAZU – Arrowhead Assault Strip – Fort Chaffee, Arkansas
KBAB (BAB) – Beale Air Force Base – Marysville, California
KBAC - Barnes County  - Valley City, North Dakota
KBAD (BAD) – Barksdale Air Force Base – Bossier City, Louisiana
KBAF (BAF) – Westfield-Barnes  – Westfield / Springfield, Massachusetts
KBAK (CLU) – Columbus  – Columbus, Indiana
KBAM (BAM) – Battle Mountain  (Lander County ) – Battle Mountain, Nevada
KBAN - Bryant Field - Bridgeport, California
KBAX – Huron County Memorial  – Bad Axe, Michigan
KBAZ – New Braunfels  – New Braunfels, Texas
KBBB (BBB) – Benson  – Benson, Minnesota
KBBD – Curtis Field – Brady, Texas
KBBG (BKG) – Branson  – Branson, Missouri
KBBP (BTN) – Marlboro County Jetport (H.E. Avent Field) – Bennettsville, South Carolina
KBBW (BBW) – Broken Bow  (Keith Glaze Field) – Broken Bow, Nebraska
KBCB (BCB) – VirginiaTech/Montgomery Executive  – Blacksburg, Virginia
KBCE (BCE) – Bryce Canyon  – Bryce Canyon, Utah
KBCK – Black River Falls Area  – Black River Falls, Wisconsin
KBCT (BCT) – Boca Raton  – Boca Raton, Florida
KBDE (BDE) – Baudette Int'l  – Baudette, Minnesota
KBDG (BDG) – Blanding  – Blanding, Utah
KBDH (ILL) – Willmar  (John L. Rice Field) – Willmar, Minnesota
KBDJ – Boulder Junction  – Boulder Junction, Wisconsin
KBDL (BDL) – Bradley Int'l  – Windsor Locks / Hartford, Connecticut
KBDN - Bend  - Bend, Oregon
KBDQ – Morrilton  – Morrilton, Arkansas
KBDR (BDR) – Igor I. Sikorsky Memorial  – Bridgeport, Connecticut
KBDU – Boulder  – Boulder, Colorado
KBEC (BEC) – Beech Factory  – Wichita, Kansas
KBED (BED) – Laurence G. Hanscom Field – Bedford, Massachusetts
KBEH (BEH) – Southwest Michigan – Benton Harbor, Michigan
KBFA – Boyne Mountain  – Boyne Falls, Michigan
KBFD (BFD) – Bradford  – Bradford, Pennsylvania
KBFE – Terry County  – Brownfield, Texas
KBFF (BFF) – Western Nebraska  (William B. Heilig Field) – Scottsbluff, Nebraska
KBFI (BFI) – Boeing Field/King County Int'l – Seattle, Washington
KBFK – Buffalo  – Buffalo, Oklahoma
KBFL (BFL) – Meadows Field  – Bakersfield, California
KBFM (BFM) – Mobile Downtown  – Mobile, Alabama
KBFR (BFR) – Virgil I. Grissom  – Bedford, Indiana
KBFW – Silver Bay  – Silver Bay, Minnesota
KBGD – Hutchinson County  – Borger, Texas
KBGE (BGE) – Decatur County Industrial Air Park – Bainbridge, Georgia
KBGF – Winchester  – Winchester, Tennessee
KBGM (BGM) – Greater Binghamton  – Binghamton, New York
KBGR (BGR) – Bangor Int'l  – Bangor, Maine
KBHB (BHB) – Hancock County-Bar Harbor  – Bar Harbor, Maine
KBHC – Baxley  – Baxley, Georgia
KBHK – Baker  – Baker, Montana
KBHM (BHM) – Birmingham-Shuttlesworth Int'l – Birmingham, Alabama
KBID (BID) – Block Island State  – Block Island, Rhode Island
KBIE – Beatrice  – Beatrice, Nebraska
KBIF (BIF) – Biggs Army  – Fort Bliss, El Paso, Texas
KBIH (BIH) – Eastern Sierra  – Bishop, California
KBIL (BIL) – Billings Logan Int'l  – Billings, Montana
KBIS (BIS) – Bismarck  – Bismarck, North Dakota
KBIV (BIV) – West Michigan  – Holland, Michigan
KBIX (BIX) – Keesler Air Force Base – Biloxi, Mississippi
KBJC (BJC) – Rocky Mountain Metropolitan – Denver, Colorado
KBJI (BJI) – Bemidji  – Bemidji, Minnesota
KBJJ (BJJ) – Wayne County  – Wooster, Ohio
KBJN - Tonopah Test Range  - Tonopah, Nevada
KBKD – Stephens County  – Breckenridge, Texas
KBKE (BKE) – Baker City  – Baker City, Oregon
KBKF – Buckley Air Force Base – Aurora, Colorado
KBKL (BKL) – Cleveland Burke Lakefront  – Cleveland, Ohio
KBKN - Blackwell-Tonkawa  - Blackwell, Oklahoma
KBKS – Brooks County  – Falfurrias, Texas
KBKT (BKT) – Allen C. Perkinson  / Blackstone Army  – Blackstone, Virginia
KBKV – Brooksville-Tampa Bay  – Brooksville, Florida
KBKW (BKW) – Beckley Raleigh County Memorial – Beckley, West Virginia
KBKX (BKX) – Brookings  – Brookings, South Dakota
KBLF (BLF) – Mercer County  – Bluefield, West Virginia
KBLH (BLH) – Blythe  – Blythe, California
KBLI (BLI) – Bellingham Int'l  – Bellingham, Washington
KBLM (BLM) – Monmouth Executive  – Belmar / Farmingdale, New Jersey
KBLU – Blue Canyon-Nyack  – Emigrant Gap, California
KBLV (BLV) – MidAmerica St. Louis  / Scott Air Force Base – Belleville, Illinois
KBMC (BMC) – Brigham City  – Brigham City, Utah
KBMG (BMG) – Monroe County  – Bloomington, Indiana
KBMI (BMI) – Central Illinois  – Bloomington, Illinois
KBML (BML) – Berlin  – Berlin, New Hampshire
KBMQ – Burnet  (Kate Craddock Field) – Burnet, Texas
KBMT (BMT) – Beaumont  – Beaumont, Texas
KBNA (BNA) – Nashville Int'l  – Nashville, Tennessee
KBNG (BNG) – Banning  – Banning, California
KBNL – Barnwell  – Barnwell, South Carolina
KBNO (BNO) – Burns  – Burns, Oregon
KBNW – Boone  – Boone, Iowa
KBOI (BOI) – Boise Air Terminal (Gowen Field) – Boise, Idaho
KBOK – Brookings  – Brookings, Oregon
KBOS (BOS) – Logan Int'l  – Boston, Massachusetts
KBOW (BOW) – Bartow  – Bartow, Florida
KBPG – Big Spring McMahon-Wrinkle  – Big Spring, Texas
KBPI (BPI) – Miley Memorial Field – Big Piney, Wyoming
KBPK (WMH) – Ozark  (formerly Baxter County ) –M ountain Home, Arkansas
KBPP (BWM) – Bowman  – Bowman, North Dakota
KBPT (BPT) – Jack Brooks  – Nederland, Texas (near Beaumont & Port Arthur)
KBQK (BQK) – Brunswick Golden Isles  – Brunswick, Georgia
KBQR (BQR) – Buffalo-Lancaster  – Lancaster, New York
KBRD (BRD) – Brainerd Lakes  – Brainerd, Minnesota
KBRL (BRL) – Southeast Iowa  – Burlington, Iowa
KBRO (BRO) – Brownsville/South Padre Island Int'l Airpor –t Brownsville, Texas
KBRY – Samuels Field – Bardstown, Kentucky
KBST – Belfast  – Belfast, Maine
KBTA - Blair  - Blair, Nebraska
KBTF (BTF) – Skypark  – Bountiful, Utah
KBTL (BTL) – W. K. Kellogg  – Battle Creek, Michigan
KBTM (BTM) – Bert Mooney  – Butte, Montana
KBTN – Britton  – Britton, South Dakota
KBTP (BTP) – Pittsburgh-Butler  (K.W. Scholter Field) – Butler, Pennsylvania
KBTR (BTR) – Baton Rouge Metropolitan  – Baton Rouge, Louisiana
KBTV (BTV) – Burlington Int'l  – Burlington, Vermont
KBTY (BTY) – Beatty  – Beatty, Nevada
KBUB – Cram Field – Burwell, Nebraska
KBUF (BUF) – Buffalo Niagara Int'l  – Buffalo, New York
KBUM – Butler Memorial  – Butler, Missouri
KBUR (BUR) – Bob Hope  – Burbank, California
KBUU – Burlington  – Burlington, Wisconsin
KBUY – Burlington-Alamance – Burlington, North Carolina
KBVI (BFP) – Beaver County  – Beaver Falls, Pennsylvania
KBVN – Albion  – Albion, Nebraska
KBVO (BVO) – Bartlesville  – Bartlesville, Oklahoma
KBVS (MVW) – Skagit  – Burlington & Mount Vernon, Washington
KBVU - Boulder City  - Boulder City, Nevada
KBVX (BVX) – Batesville  – Batesville, Arkansas
KBVY (BVY) – Beverly  – Beverly, Massachusetts
KBWC (BWC) – Brawley  – Brawley, California
KBWD (BWD) – Brownwood  – Brownwood, Texas
KBWG (BWG) – Bowling Green-Warren County  – Bowling Green, Kentucky
KBWI (BWI) – Baltimore-Washington Int'l Thurgood Marshall  – Baltimore
KBWP – Harry Stern  – Wahpeton, North Dakota
KBXA (BXA) – George R. Carr Memorial  – Bogalusa, Louisiana
KBXG – Burke County  – Waynesboro, Georgia
KBXK (BXK) – Buckeye  – Buckeye, Arizona
KBXM (BXM) – Brunswick Executive  (formerly NAS Brunswick) – Brunswick, Maine
KBYG (BYG) – Johnson County  – Buffalo, Wyoming
KBYH (BYH) – Arkansas Int'l  – Blytheville, Arkansas
KBYI (BYI) – Burley  – Burley, Idaho
KBYS – Bicycle Lake Army  (Fort Irwin) – Barstow, California
KBYY (BBC) – Bay City  – Bay City, Texas
KBZN (BZN) – Gallatin Field  – Bozeman, Montana
KCAD (CAD) – Wexford County  – Cadillac, Michigan
KCAE (CAE) – Columbia Metropolitan  – West Columbia, South Carolina (near Columbia)
KCAG (CIG) – Craig-Moffat  – Craig, Colorado
KCAK (CAK) – Akron-Canton  – Akron, Ohio (near Canton)
KCAO (CAO) – Clayton Airpark – Clayton, New Mexico
KCAR (CAR) – Caribou  – Caribou, Maine
KCAV – Clarion  – Clarion, Iowa
KCBE (CBE) – Greater Cumberland – Cumberland, Maryland
KCBF (CBF) – Council Bluffs  – Council Bluffs, Iowa
KCBG – Cambridge  – Cambridge, Minnesota
KCBK (CBK) – Colby  (Shalz Field) – Colby, Kansas
KCBM (CBM) – Columbus Air Force Base – Columbus, Mississippi
KCCA – Clinton  – Clinton, Arkansas
KCCB (CCB) – Cable  – Upland, California
KCCO – Newnan-Coweta County  – Newnan, Georgia
KCCR (CCR) – Buchanan Field  – Concord, California
KCCY (CCY) – Northeast Iowa  – Charles City, Iowa
KCDA (LLX) – Caledonia County  – Lyndonville, Vermont
KCDC (CDC) – Cedar City  – Cedar City, Utah
KCDD – Scotts Seaplane Base – Crane Lake, Minnesota
KCDH – Harrell Field (Camden/Regional ) –C amden, Arkansas
KCDI – Cambridge  – Cambridge, Ohio
KCDK (CDK) – George T. Lewis  – Cedar Key, Florida
KCDN (CDN) – Woodward Field (Kershaw County ) – Camden, South Carolina
KCDR (CDR) – Chadron  – Chadron, Nebraska
KCDS (CDS) – Childress  – Childress, Texas
KCDW (CDW) – Essex County  (Caldwell ) – Caldwell, New Jersey
KCEA (CEA) – Cessna Aircraft Field – Wichita, Kansas
KCEC (CEC) – Jack McNamara Field – Crescent City, California
KCEF (CEF) – Westover Metropolitan  / Westover Air Reserve Base – Springfield / Chicopee, Massachusetts
KCEK – Crete  – Crete, Nebraska
KCEU (CEU) – Oconee County  – Clemson, South Carolina
KCEV (CEV) – Mettel Field – Connersville, Indiana
KCEW (CEW) – Bob Sikes  – Crestview, Florida
KCEY (CEY) – Murray-Calloway County  (Kyle-Oakley Field) – Murray, Kentucky
KCEZ (CEZ) – Cortez  – Cortez, Colorado
KCFD (CFD) – Coulter Field – Bryan, Texas
KCFE – Buffalo  – Buffalo, Minnesota
KCFJ – Crawfordsville  – Crawfordsville, Indiana
KCFS – Tuscola Area  – Caro, Michigan
KCFT (CFT) – Greenlee County  – Clifton / Morenci, Arizona
KCFV (CFV) – Coffeyville  – Coffeyville, Kansas
KCGC – Crystal River  (Captain Tom Davis Field) – Crystal River, Florida
KCGE (CGE) – Cambridge-Dorchester – Cambridge, Maryland
KCGF (CGF) – Cuyahoga County  – Cleveland, Ohio
KCGI (CGI) – Cape Girardeau  – Cape Girardeau, Missouri
KCGS (CGS) – College Park  – College Park, Maryland
KCGZ (CGZ) – Casa Grande  – Casa Grande, Arizona
KC

KCHA (CHA) – Chattanooga Metropolitan  – Chattanooga, Tennessee
KCHD – Chandler  – Chandler, Arizona
KCHK (CHK) – Chickasha  – Chickasha, Oklahoma
KCHN – Wauchula  – Wauchula, Florida
KCHO (CHO) – Charlottesville-Albemarle  – Charlottesville, Virginia
KCHQ – Mississippi County  – Charleston, Missouri
KCHS (CHS) – Charleston Int'l  (Charleston Air Force Base) – Charleston, South Carolina
KCHT – Chillicothe  – Chillicothe, Missouri
KCHU – Houston County  – Caledonia, Minnesota
KCIC (CIC) – Chico  – Chico, California
KCID (CID) – The Eastern Iowa  – Cedar Rapids, Iowa
KCII – Choteau  – Choteau, Montana
KCIN (CIN) – Arthur N. Neu  – Carroll, Iowa
KCIR – Cairo  – Cairo, Illinois
KCIU (CIU) – Chippewa County Int'l – Sault Ste Marie, Michigan
KCJJ – Ellen Church Field – Cresco, Iowa
KCJR – Culpeper  – Culpeper, Virginia
KCKA (CKA) – Kegelman Air Force Auxiliary Field – Cherokee, Oklahoma
KCKB (CKB) – Harrison/Marion  – Clarksburg, West Virginia
KCKC (GRM) – Grand Marais/Cook County  – Grand Marais, Minnesota
KCKF (CKF) – Crisp County-Cordele  – Cordele, Georgia
KCKI – Williamsburg  – Kingstree, South Carolina
KCKM – Fletcher Field – Clarksdale, Mississippi
KCKN (CKN) – Crookston  – Crookston, Minnesota
KCKP – Cherokee  – Cherokee, Iowa
KCKV (CKV) – Clarksville-Montgomery County (John F. Outlaw Field) – Clarksville, Tennessee
KCLE (CLE) – Cleveland Hopkins Int'l – Cleveland, Ohio
KCLI (CLI) – Clintonville  – Clintonville, Wisconsin
KCLK – Clinton  – Clinton, Oklahoma
KCLL (CLL) – Easterwood  – College Station, Texas
KCLM (CLM) – William R. Fairchild Int'l – Port Angeles, Washington
KCLR (CLR) – Cliff Hatfield Memorial  – Calipatria, California
KCLS (CLS) – Chehalis-Centralia  – Chehalis, Washington
KCLT (CLT) – Charlotte/Douglas Int'l – Charlotte, North Carolina
KCLW (CLW) – Clearwater Air Park – Clearwater, Florida
KCMA – Camarillo  – Camarillo, California
KCMH (CMH) – John Glenn Columbus Int'l – Columbus, Ohio
KCMI (CMI) – University of Illinois Willard  – Savoy, Illinois (Champaign-Urbana area)
KCMR – H.A. Clark Memorial Field – Williams, Arizona
KCMX (CMX) – Houghton County Memorial  – Hancock, Michigan
KCMY (CMY) – Sparta/Fort McCoy  – Sparta, Wisconsin
KCNC – Chariton  – Chariton, Iowa
KCNH (CNH) – Claremont  – Claremont, New Hampshire
KCNI – Cherokee County  – Canton, Georgia
KCNK (CNK) – Blosser  – Concordia, Kansas
KCNM (CNM) – Cavern City Air Terminal – Carlsbad, New Mexico
KCNO (CNO) – Chino  – Chino, California
KCNP – Billy G. Ray Field – Chappell, Nebraska
KCNU (CNU) – Chanute Martin Johnson  – Chanute, Kansas
KCNW (CNW) – TSTC Waco  – Waco, Texas
KCNY (CNY) – Canyonlands Field – Moab, Utah
KCOD (COD) – Yellowstone  – Cody, Wyoming
KCOE (COE) – Coeur d'Alene Air Terminal – Coeur d'Alene, Idaho
KCOF (COF) – Patrick Air Force Base – Cocoa Beach, Florida
KCOI (COI) – Merritt Island  – Merritt Island, Florida
KCOM – Coleman  – Coleman, Texas
KCON (CON) – Concord  – Concord, New Hampshire
KCOQ – Cloquet Carlton County  – Cloquet, Minnesota
KCOS (COS) – Colorado Springs  (City of Colorado Springs ) –C olorado Springs, Colorado
KCOT (COT) – Cotulla-La Salle County  – Cotulla, Texas
KCOU (COU) – Columbia  – Columbia, Missouri
KCPC – Columbus County  – Whiteville, North Carolina
KCPK – Chesapeake  – Norfolk, Virginia
KCPM (CPM) – Compton/Woodley  – Compton, California
KCPR (CPR) – Natrona County Int'l – Casper, Wyoming
KCPS (CPS) – St. Louis Downtown  – Cahokia, Illinois
KCPT – Cleburne  – Cleburne, Texas
KCPU (CPU) – Calaveras County  (Maury Rasmussen Field) – San Andreas, California
KCQA – Lakefield  – Celina, Ohio
KCQB – Chandler  – Chandler, Oklahoma
KCQC - Moriarty  - Moriarty, New Mexico
KCQF – H. L. Sonny Callahan  – Fairhope, Alabama
KCQM – Cook  – Cook, Minnesota
KCQW (HCW) – Cheraw  (Lynch Bellinger Field) – Cheraw, South Carolina
KCQX – Chatham  – Chatham, Massachusetts
KCRE (CRE) – Grand Strand  – North Myrtle Beach, South Carolina
KCRG (CRG) – Jacksonville Executive at Craig – Jacksonville, Florida
KCRO (CRO) – Corcoran  – Corcoran, California
KCRP (CRP) – Corpus Christi Int'l  – Corpus Christi, Texas
KCRQ (CLD) – McClellan-Palomar  – Carlsbad, California
KCRS – Corsicana  (C. David Campbell Field) – Corsicana, Texas
KCRT (CRT) – Z.M. Jack Stell Field – Crossett, Arkansas
KCRW (CRW) – Yeager  – Charleston, West Virginia
KCRX (CRX) – Roscoe Turner  – Corinth, Mississippi
KCRZ – Corning  – Corning, Iowa
KCSB – Cambridge  – Cambridge, Nebraska
KCSG (CSG) – Columbus  – Columbus, Georgia
KCSM (CSM) – Clinton-Sherman Industrial Airpark (Oklahoma Air & Space Port) – Clinton, Oklahoma
KCSQ (CSQ) – Creston  – Creston, Iowa
KCSV (CSV) – Crossville Memorial  (Whitson Field) – Crossville, Tennessee
KCTB (CTB) – Cut Bank  – Cut Bank, Montana
KCTJ – West Georgia  (O.V. Gray Field) – Carrollton, Georgia
KCTK – Ingersoll  – Canton, Illinois
KCTY (CTY) – Cross City  – Cross City, Florida
KCTZ (CTZ) – Clinton-Sampson County  – Clinton, North Carolina
KCUB (CUB) – Columbia Owens Downtown  – Columbia, South Carolina
KCUH – Cushing  – Cushing, Oklahoma
KCUL – Carmi  – Carmi, Illinois
KCUT – Custer County  – Custer, South Dakota
KCVG (CVG) – Cincinnati/Northern Kentucky Int'l – Hebron, Kentucky (near Cincinnati, Ohio and Covington, Kentucky)
KCVH (HLI) – Hollister  – Hollister, California
KCVK – Sharp County  – Ash Flat, Arkansas
KCVN (CVN) – Clovis  – Clovis, New Mexico
KCVO (CVO) – Corvallis  – Corvallis, Oregon
KCVS (CVS) – Cannon Air Force Base – Clovis, New Mexico
KCVX – Charlevoix  – Charlevoix, Michigan
KCWA (CWA) – Central Wisconsin  – Mosinee, Wisconsin
KCWC - Kickapoo Downtown Airpark - Wichita Falls, Texas
KCWF (CWF) – Chennault Int'l  – Lake Charles, Louisiana
KCWI – Clinton  – Clinton, Iowa
KCWS – Dennis F. Cantrell Field – Conway, Arkansas (closed/replaced, see: KCXW)
KCWV – Claxton-Evans County  – Claxton, Georgia
KCXE – Chase City  – Chase City, Virginia
KCXL (CXL) – Calexico Int'l  – Calexico, California
KCXO (CXO) – Lone Star Executive  – Houston, Texas
KCXP (CXP) – Carson City  – Carson City, Nevada
KCXU – Camilla-Mitchell County  – Camilla, Georgia
KCXW – Conway  (Cantrell Field) – Conway, Arkansas
KCXY (HAR) – Capital City  – Harrisburg, Pennsylvania
KCYO – Pickaway County Memorial  – Circleville, Ohio
KCYS (CYS) – Cheyenne  (Jerry Olson Field) – Cheyenne, Wyoming
KCYW – Clay Center  – Clay Center, Kansas
KCZD – Cozad  – Cozad, Nebraska
KCZG (CZG) – Tri-Cities  – Endicott, New York
KCZK (CZK) – Cascade Locks State  – Cascade Locks, Oregon
KCZL – Tom B. David Field – Calhoun, Georgia
KCZT – Dimmit County  – Carrizo Springs, Texas
KDAA (DAA) – Davison Army  – Fort Belvoir, Virginia
KDAB (DAB) – Daytona Beach Int'l – Daytona Beach, Florida
KDAF – Necedah  – Necedah, Wisconsin
KDAG – Barstow-Daggett  – Daggett, California
KDAL (DAL) – Dallas Love Field – Dallas, Texas
KDAN (DAN) – Danville  – Danville, Virginia
KDAW – Skyhaven  – Rochester, New Hampshire
KDAY (DAY) – James M. Cox Int'l  – Dayton, Ohio
KDBN – W. H. 'Bud' Barron  – Dublin, Georgia
KDBQ (DBQ) – Dubuque  – Dubuque, Iowa
KDCA (DCA) – Ronald Reagan Washington National  – Arlington County, Virginia (near Washington, DC)
KDCU – Pryor Field  – Decatur, Alabama
KDCY – Daviess County  – Washington, Indiana
KDDC (DDC) – Dodge City  – Dodge City, Kansas
KDDH – William H. Morse State  – Bennington, Vermont
KDEC (DEC) – Decatur  – Decatur, Illinois
KDED – DeLand  (Sidney H. Taylor Field) – DeLand, Florida
KDEH – Decorah  – Decorah, Iowa
KDEN (DEN) – Denver Int'l  (replaced Stapleton Int'l) – Denver, Colorado
KDEQ (DEQ) – J. Lynn Helms Sevier County  – De Queen, Arkansas
KDET (DET) – Coleman A. Young  – Detroit, Michigan
KDEW – Deer Park  – Deer Park, Washington
KDFI – Defiance Memorial  – Defiance, Ohio
KDFW (DFW) – Dallas-Fort Worth Int'l  – Dallas / Fort Worth, Texas
KDGL (DGL) – Douglas  – Douglas, Arizona
KDGW (DGW) – Converse County  – Douglas, Wyoming
KDHN (DHN) – Dothan  – Dothan, Alabama
KDHT – Dalhart  – Dalhart, Texas
KDIJ - Driggs-Reed Memorial  - Driggs, Idaho
KDIK (DIK) – Dickinson – Theodore Roosevelt – Dickinson, North Dakota
KDKB – DeKalb Taylor  – DeKalb, Illinois
KDKK – Chautauqua County/Dunkirk  – Dunkirk, New York
KDKR (DKR) – Houston County  – Crockett, Texas
KD

KDKX – Knoxville Downtown Island  – Knoxville, Tennessee
KDLC – Dillon County  – Dillon, South Carolina
KDLF (DLF) – Laughlin Air Force Base – Del Rio, Texas
KDLH (DLH) – Duluth Int'l  – Duluth, Minnesota
KDLL – Baraboo-Wisconsin Dells  – Baraboo, Wisconsin
KDLN – Dillon  – Dillon, Montana
KDLO – Delano  – Delano, California
KDLS (DLS) – Columbia Gorge  (The Dalles ) – The Dalles, Oregon
KDLZ (DLZ) – Delaware  – Delaware, Ohio
KDMA (DMA) – Davis-Monthan Air Force Base – Tucson, Arizona
KDMN (DMN) – Deming  – Deming, New Mexico
KDMO (DMO) – Sedalia  – Sedalia, Missouri
KDMW – Carroll County  (Jack B. Poage Field) – Westminster, Maryland
KDNL – Daniel Field – Augusta, Georgia
KDNN – Dalton  – Dalton, Georgia
KDNS – Denison  – Denison, Iowa
KDNV (DNV) – Vermilion  – Danville, Illinois
KDOV (DOV) – Dover Air Force Base – Dover, Delaware
KDPA – Dupage  – West Chicago, Illinois
KDPG – Michael Army  – Dugway Proving Ground, Utah
KDPL – Duplin County  – Kenansville, North Carolina
KDQH – Douglas  – Douglas, Georgia
KDRA – Desert Rock  – Mercury, Nevada
KDRI (DRI) – Beauregard  – De Ridder, Louisiana
KDRO – Durango-La Plata County  – Durango, Colorado
KDRT – Del Rio Int'l  – Del Rio, Texas
KDRU – Drummond  – Drummond, Montana
KDSM (DSM) – Des Moines Int'l  – Des Moines, Iowa
KDSV – Dansville  – Dansville, New York
KDTA – Delta  – Delta, Utah
KDTG – Dwight  – Dwight, Illinois
KDTL (DTL) – Detroit Lakes  (Wething Field) – Detroit Lakes, Minnesota
KDTN (DTN) – Shreveport Downtown  – Shreveport, Louisiana
KDTO – Denton Enterprise  – Denton, Texas
KDTS – Destin Executive  – Destin, Florida
KDTW (DTW) – Detroit Metropolitan Wayne County  – Romulus, Michigan (near Detroit)
KDUA (DUA) – Durant -Eaker Field – Durant, Oklahoma
KDUC – Halliburton Field (Duncan ) – Duncan, Oklahoma
KDUG – Bisbee-Douglas Int'l – Bisbee / Douglas, Arizona
KDUH – Toledo Suburban  – Lambertville, Michigan
KDUJ (DUJ) – DuBois  (formerly DuBois-Jeferson County ) – DuBois, Pennsylvania
KDUX (DUX) – Moore County  – Dumas, Texas
KDVK – Stuart Powell Field – Danville, Kentucky
KDVL (DVL) – Devils Lake  (Devils Lake ) – Devils Lake, North Dakota
KDVN – Davenport  – Davenport, Iowa
KDVO – Gnoss Field (Marin County ) – Novato, California
KDVP – Slayton  – Slayton, Minnesota
KDVT – Phoenix Deer Valley  – Phoenix, Arizona
KDWH – David Wayne Hooks Memorial  – Spring, Texas
KDWU – Ashland  – Ashland, Kentucky
KDXE – Dexter  – Dexter, Missouri
KDXR – Danbury  – Danbury, Connecticut
KDXX – Lac qui Parle County  – Madison, Minnesota
KDXZ – St. George  – St. George, Utah
KDYA (DYA) – Demopolis (Julian D. "Buzz" Sawyer ) – Demopolis, Alabama
KDYB (DYB) – Summerville  – Summerville, South Carolina
KDYL – Doylestown  – Doylestown, Pennsylvania
KDYR – Dyersburg  – Dyersburg, Tennessee
KDYS (DYS) – Dyess Air Force Base – Abilene, Texas
KDYT – Sky Harbor  – Duluth, Minnesota
KDZJ (DZJ) – Blairsville  – Blairsville, Georgia
KEAG – Eagle Grove  – Eagle Grove, Iowa
KEAN (EAN) – Phifer  – Wheatland, Wyoming
KEAR (EAR) – Kearney  – Kearney, Nebraska
KEAT – Pangborn Memorial  – Wenatchee, Washington
KEAU (EAU) – Chippewa Valley  – Eau Claire, Wisconsin
KEBG (EBG) – South Texas Int'l  at Edinburg (Edinburg Int'l ) – Edinburg, Texas
KEBS – Webster City  – Webster City, Iowa
KECG (ECG) – Elizabeth City  / Elizabeth City CGAS (Elizabeth City-Pasquotank County ) – Elizabeth City, North Carolina
KECS (ECS) – Mondell Field – Newcastle, Wyoming
KECU – Edwards County  – Rocksprings, Texas
KEDC – Austin Executive  (Bird's Nest ) – Austin, Texas
KEDE (EDE) – Northeastern  – Edenton, North Carolina
KEDG – Weide Army Heliport – Edgewood Arsenal, Aberdeen Proving Ground, Maryland
KEDJ (EDJ) – Bellefontaine  – Bellefontaine, Ohio
KEDN – Enterprise  – Enterprise, Alabama
KEDU - University  - Davis, California
KEDW (EDW) – Edwards Air Force Base – Rosamond, California
KEED – Needles  – Needles, California
KEEN (EEN) – Dillant-Hopkins  – Keene, New Hampshire
KEEO – Meeker  – Meeker, Colorado
KEET – Shelby County  – Alabaster, Alabama
KEFC – Belle Fourche  – Belle Fourche, South Dakota
KEFD – Ellington Field Joint Reserve Base – Houston, Texas
KEFK – Northeast Kingdom Int'l – Newport, Vermont
KEFT – Monroe  – Monroe, Wisconsin
KEFW – Jefferson  – Jefferson, Iowa
KEGE (EGE) – Eagle County  – Eagle, Colorado (near Vail)
KEGI – Duke Field (Eglin Auxiliary Field 3) – Crestview, Florida
KEGQ – Emmetsburg  – Emmetsburg, Iowa
KEGT – Wellington  – Wellington, Kansas
KEGV – Eagle River Union  – Eagle River, Wisconsin
KEHA – Elkhart-Morton County  – Elkhart, Kansas
KEHO (EHO) – Shelby-Cleveland County – Shelby, North Carolina
KEHR – Henderson City-County  – Henderson, Kentucky
KEIK – Erie  – Erie, Colorado
KEIW – County Memorial  – New Madrid, Missouri
KEKA (EKA) – Murray Field – Eureka, California
KEKM – Elkhart  – Elkhart, Indiana
KEKN (EKN) – Elkins-Randolph County  (Jennings Randolph Field) – Elkins, West Virginia
KEKO (EKO) – Elko  – Elko, Nevada
KEKQ – Wayne County  – Monticello, Kentucky
KEKS (EKS) – Ennis - Big Sky  – Ennis, Montana,
KEKX – Elizabethtown  (Addington Field) – Elizabethtown, Kentucky
KEKY – Bessemer  – Bessemer, Alabama
KE

KELA – Eagle Lake  – Eagle Lake, Texas
KELD (ELD) – South Arkansas  at Goodwin Field – El Dorado, Arkansas
KELK (ELK) – Elk City Regional Business  – Elk City, Oklahoma
KELM (ELM) – Elmira/Corning  – Big Flats, New York (near Elmira & Corning)
KELN – Bowers Field – Ellensburg, Washington
KELO (ELO) – Ely  – Ely, Minnesota
KELP (ELP) – El Paso Int'l  – El Paso, Texas
KELY – Ely  (Yelland Field) – Ely, Nevada
KELZ – Wellsville  (Tarantine Field) – Wellsville, New York
KEMM (EMM) – Kemmerer  – Kemmerer, Wyoming
KEMP – Emporia  – Emporia, Kansas
KEMT – San Gabriel Valley  – El Monte, California
KEMV – Emporia-Greensville – Emporia, Virginia
KEND (END) – Vance Air Force Base – Enid, Oklahoma
KENL – Centralia  – Centralia, Illinois
KENV – Wendover  – Wendover, Utah
KENW (ENW) – Kenosha  – Kenosha, Wisconsin
KEOE – Newberry County  – Newberry, South Carolina
KEOK – Keokuk  – Keokuk, Iowa
KEOP – Pike County  – Waverly, Ohio
KEOS – Neosho Hugh Robinson  – Neosho, Missouri
KEPG – Browns  – Weeping Water, Nebraska
KEPH – Ephrata  – Ephrata, Washington
KEPM – Eastport  – Eastport, Maine
KEQA – El_Dorado/Captain Jack Thomas Memorial – El Dorado, Kansas
KEQY (EQY) – Monroe  – Monroe, North Carolina
KERI (ERI) – Erie Int'l  (Tom Ridge Field) – Erie, Pennsylvania
KERR – Errol  – Errol, New Hampshire
KERV – Kerrville  (Louis Schreiner Field) – Kerrville, Texas
KERY (ERY) – Luce County  – Newberry, Michigan
KESC – Delta County  – Escanaba, Michigan
KESF (ESF) – Esler  – Alexandria, Louisiana
KESN (ESN) – Easton  (Newnan Field) – Easton, Maryland
KEST – Estherville  – Estherville, Iowa
KESW – Easton State  – Easton, Washington
KETB – West Bend  – West Bend, Wisconsin
KETC – Tarboro-Edgecombe  – Tarboro, North Carolina
KETN – Eastland  – Eastland, Texas
KEUF (EUF) – Weedon Field – Eufaula, Alabama
KEUG (EUG) – Eugene  / Mahlon Sweet Field – Eugene, Oregon
KEUL – Caldwell Industrial  – Caldwell, Idaho
KEVB – New Smyrna Beach (Jack Bolt Field) – New Smyrna Beach, Florida
KEVM – Eveleth-Virginia  – Eveleth, Minnesota
KEVU (EVU) – Northwest Missouri – Maryville, Missouri
KEVV (EVV) – Evansville  – Evansville, Indiana
KEVW (EVW) – Evanston-Uinta County  (Burns Field) – Evanston, Wyoming
KEVY – Summit  – Middletown, Delaware
KEWB (EWB) – New Bedford  – New Bedford, Massachusetts
KEWK – Newton City/County  – Newton, Kansas
KEWN (EWN) – Craven County  – New Bern, North Carolina
KEWR (EWR) – Newark Liberty Int'l – Newark & Elizabeth, New Jersey
KEXX (EXX) – Davidson County  – Lexington, North Carolina
KEYE (EYE) – Eagle Creek Airpark – Indianapolis, Indiana
KEYF – Curtis L. Brown Jr. Field – Elizabethtown, North Carolina
KEYQ – Weiser Air Park – Houston, Texas
KEYW (EYW) – Key West Int'l  – Key West, Florida
KEZF – Shannon  – Fredericksburg, Virginia
KEZI – Kewanee  – Kewanee, Illinois
KEZM – Heart of Georgia  – Eastman, Georgia
KEZS (EZS) – Shawano  – Shawano, Wisconsin
KEZZ – Cameron Memorial  – Cameron, Missouri
KFAF – Joint Base Langley-Eustis (formerly Felker Army ) – Fort Eustis, Virginia
KFAM – Farmington  – Farmington, Missouri
KFAR (FAR) – Hector Int'l  – Fargo, North Dakota
KFAT (FAT) – Fresno Yosemite Int'l  – Fresno, California
KFAY (FAY) – Fayetteville  (Grannis Field) – Fayetteville, North Carolina
KFBG (FBG) – Simmons Army  – Fort Bragg, North Carolina
KFBL – Faribault  – Faribault, Minnesota
KFBR (FBR) – Fort Bridger  – Fort Bridger, Wyoming
KFBY – Fairbury  – Fairbury, Nebraska
KFCA – Glacier Park Int'l  – Kalispell, Montana
KFCH – Fresno Chandler Executive  – Fresno, California
KFCI – Chesterfield County  – Richmond, Virginia
KFCM – Flying Cloud  – Minneapolis, Minnesota
KFCS – Butts Army  (Fort Carson) – Fort Carson, Colorado
KFCT – Vagabond Army Heliport – Yakima, Washington
KFCY – Forrest City  – Forrest City, Arkansas
KFDK – Frederick  – Frederick, Maryland
KFDR (FDR) – Frederick  – Frederick, Oklahoma
KFDW – Fairfield County  – Winnsboro, South Carolina
KFDY – Findlay  – Findlay, Ohio
KFEP – Albertus  – Freeport, Illinois
KFES – Festus Memorial  – Festus, Missouri
KFET – Fremont  – Fremont, Nebraska
KFFA – First Flight  – Kill Devil Hills, North Carolina
KFFC – Atlanta  (Falcon Field) – Peachtree City, Georgia
KFFL – Fairfield  – Fairfield, Iowa
KFFM – Fergus Falls  (Einar Mickelson Field) – Fergus Falls, Minnesota
KFFO (FFO) – Wright-Patterson Air Force Base – Dayton, Ohio
KFFT – Capital City  – Frankfort, Kentucky
KFFZ (FFZ) – Falcon Field – Mesa, Arizona
KFGX – Fleming-Mason  – Flemingsburg, Kentucky
KFHB – Fernandina Beach  – Fernandina Beach, Florida
KFHR – Friday Harbor  – Friday Harbor, Washington
KFHU (FHU) – Sierra Vista  / Libby Army  – Fort Huachuca / Sierra Vista, Arizona
KFIG – Clearfield-Lawrence  – Clearfield, Pennsylvania
KFIT (FIT) – Fitchburg  – Fitchburg, Massachusetts
KFKA – Fillmore County  – Preston, Minnesota
KFKL (FKL) – Venango  – Franklin, Pennsylvania
KFKN – Franklin-John Beverly Rose – Franklin, Virginia
KFKR – Frankfort  – Frankfort, Indiana
KFKS – Frankfort Dow Memorial Field – Frankfort, Michigan
KFLD – Fond du Lac County  – Fond du Lac, Wisconsin
KFLG (FLG) – Flagstaff Pulliam  – Flagstaff, Arizona
KFLL (FLL) – Fort Lauderdale-Hollywood Int'l – Fort Lauderdale / Hollywood, Florida
KFLO (FLO) – Florence  – Florence, South Carolina
KF

KFLP – Marion County  – Flippin, Arkansas
KFLV (FLV) – Sherman Army  – Fort Leavenworth, Kansas
KFLX – Fallon  – Fallon, Nevada
KFLY – Meadow Lake  – Colorado Springs, Colorado
KFME (FME) – Tipton  – Fort Meade / Odenton, Maryland
KFMH – Otis Air National Guard Base – Falmouth, Massachusetts
KFMM – Fort Morgan  – Fort Morgan, Colorado
KFMN – Four Corners  – Farmington, New Mexico
KFMY (FMY) – Page Field – Fort Myers, Florida
KFMZ – Fairmont State  – Fairmont, Nebraska
KFNB – Brenner Field – Falls City, Nebraska
KFNL – Fort Collins-Loveland – Fort Collins / Loveland, Colorado
KFNT (FNT) – Bishop Int'l  – Flint, Michigan
KFOA – Flora  – Flora, Illinois
KFOD (FOD) – Fort Dodge  – Fort Dodge, Iowa
KFOE (FOE) – Forbes Field – Topeka, Kansas
KFOK – Francis S. Gabreski  – Westhampton Beach, New York
KFOM – Fillmore  – Fillmore, Utah
KFOT – Rohnerville  – Fortuna, California
KFOZ – Bigfork  – Bigfork, Minnesota
KFPK (FPK) – Fitch H. Beach  – Charlotte, Michigan
KFPR (FPR) – St. Lucie County Int'l – Fort Pierce, Florida
KFQD – Rutherford County  (Marchman Field) – Rutherfordton, North Carolina
KFRG (FRG) – Republic  – East Farmingdale, New York
KFRH – French Lick  – French Lick, Indiana
KFRI (FRI) – Marshall Army  – Fort Riley / Junction City, Kansas
KFRM – Fairmont  – Fairmont, Minnesota
KFRR – Front Royal-Warren County  – Front Royal, Virginia
KFSD (FSD) – Sioux Falls  (Joe Foss Field) – Sioux Falls, South Dakota
KFSE – Fosston  – Fosston, Minnesota
KFSI (FSI) – Henry Post Army  – Fort Sill / Lawton, Oklahoma
KFSK – Fort Scott  – Fort Scott, Kansas
KFSM (FSM) – Fort Smith  – Fort Smith, Arkansas
KFSO – Franklin County State  – Highgate, Vermont
KFST – Fort Stockton-Pecos County  – Fort Stockton, Texas
KFSU – Fort Sumner  – Fort Sumner, New Mexico
KFSW – Fort Madison  – Fort Madison, Iowa
KFTG – Front Range  – Aurora, Colorado
KFTK (FTK) – Godman Army  – Fort Knox, Kentucky
KFTT – Elton Hensley Memorial  – Fulton, Missouri
KFTW (FTW) – Fort Worth Meacham Int'l  – Fort Worth, Texas
KFTY (FTY) – Fulton County  (Charlie Brown Field) – Atlanta, Georgia
KFUL – Fullerton  – Fullerton, California
KFVE (FVE) – Northern Aroostook – Frenchville, Maine
KFVX – Farmville  – Farmville, Virginia
KFWA (FWA) – Fort Wayne Int'l  – Fort Wayne, Indiana
KFWC – Fairfield  – Fairfield, Illinois
KFWN – Sussex  – Sussex, New Jersey
KFWQ (FWQ) – Rostraver  – Monongahela, Pennsylvania
KFWS – Fort Worth Spinks  – Fort Worth, Texas
KFXE – Fort Lauderdale Executive  – Fort Lauderdale, Florida
KFXY – Forest City  – Forest City, Iowa
KFYE – Fayette County  – Somerville, Tennessee
KFYJ (FYJ) – Middle Peninsula  – West Point, Virginia
KFYM – Fayetteville  – Fayetteville, Tennessee
KFYV (FYV) – Drake Field (Fayetteville Executive ) – Fayetteville, Arkansas
KFZG – Fitzgerald  – Fitzgerald, Georgia
KFZI – Fostoria Metropolitan  – Fostoria, Ohio
KFZY – Oswego County  – Fulton, New York
KGAB – Gabbs  – Gabbs, Nevada
KGAD – Northeast Alabama – Gadsden, Alabama
KGAF (GAF) – Grafton  – Grafton, North Dakota
KGAG - Gage  - Gage, Oklahoma
KGAI – Montgomery County Airpark – Gaithersburg, Maryland
KGBD – Great Bend  – Great Bend, Kansas
KGBN – Gila Bend Air Force Auxiliary Field – Gila Bend, Arizona
KGBR – Walter J. Koladza  (Great Barrington ) – Great Barrington, Massachusetts
KGCC (GCC) – Gillette-Campbell County  – Gillette, Wyoming
KGCD - Seneca Emergency Airstrip - Seneca, Oregon
KGCK (GCK) – Garden City  – Garden City, Kansas
KGCM - Claremore  - Claremore, Oklahoma
KGCN (GCN) – Grand Canyon National Park – Grand Canyon National Park, Arizona
KGDJ (GDJ) – Granbury  – Granbury, Texas
KGDM (GDM) – Gardner  – Gardner, Massachusetts
KGDP - Dell City  - Dell City, Texas
KGDV – Dawson Community  – Glendive, Montana
KGDY – Grundy  – Grundy, Virginia
KGED – Delaware Coastal  (Georgetown ) – Georgetown, Delaware
KGEG (GEG) – Spokane Int'l  – Spokane, Washington
KGEU – Glendale  – Glendale, Arizona
KGEV – Ashe County  – Jefferson, North Carolina
KGEY (GEY) – South Big Horn County  – Greybull, Wyoming
KGFA (GFA) – Malmstrom Air Force Base – Great Falls, Montana
KGFK (GFK) – Grand Forks Int'l  – Grand Forks, North Dakota
KGFL (GFL) – Floyd Bennett Memorial  – Glens Falls, New York
KGGE – Georgetown County  – Georgetown, South Carolina
KGGF – Grant  – Grant, Nebraska
KGGG (GGG) – East Texas  – Longview, Texas
KGGI – Grinnell  (Billy Robinson Field) – Grinnell, Iowa
KGGW (GGW) – Glasgow  – Glasgow, Montana
KGHG (GHG) – Marshfield  (George Harlow Field) – Marshfield, Massachusetts
KGHM – Centerville  – Centerville, Tennessee
KGIC - Idaho County  - Grangeville, Idaho
KGIF – Winter Haven's Gilbert  (Gilbert Field) – Winter Haven, Florida
KGJT (GJT) – Grand Junction  (Walker Field) – Grand Junction, Colorado
KGKJ – Port Meadville  – Meadville, Pennsylvania
KGKT (GKT) – Gatlinburg-Pigeon Forge  – Sevier County, Tennessee
KGKY – Arlington  – Arlington, Texas
KGLD – Goodland  (Renner Field) – Goodland, Kansas
KGLH (GLH) – Mid Delta  – Greenville, Mississippi
KGLS (GLS) – Scholes Int'l  at Galveston – Galveston, Texas
KGLW – Glasgow  – Glasgow, Kentucky
KGMJ - Grove  - Grove, Oklahoma
KGMU – Greenville Downtown  – Greenville, South Carolina
KGNB – Granby-Grand County  – Granby, Colorado
KGNC - Gaines County  - Seminole, Texas
KG

KGNF – Grenada  – Grenada, Mississippi
KGNG – Gooding  – Gooding, Idaho
KGNI – Grand Isle Seaplane Base – Grand Isle, Louisiana
KGNT – Grants-Milan  – Grants, New Mexico
KGNV (GNV) – Gainesville  – Gainesville, Florida
KGOK - Guthrie-Edmond  - Guthrie, Oklahoma
KGON (GON) – Groton-New London  – Groton / New London, Connecticut
KGOO – Nevada County Air Park (Nevada County ) – Grass Valley, California
KGOV – Grayling Army  – Grayling, Michigan
KGPI - Kalispell City  - Kalispell, Montana
KGPT (GPT) – Gulfport-Biloxi Int'l  – Gulfport, Mississippi
KGRB (GRB) – Austin Straubel Int'l – Green Bay, Wisconsin
KGRD – Greenwood County  – Greenwood, South Carolina
KGRF (GRF) – Gray Army  – Fort Lewis, Washington
KGRI (GRI) – Central Nebraska  – Grand Island, Nebraska
KGRK (GRK) – Killeen-Fort Hood  / Gray Army  – Fort Hood, Killeen, Texas
KGRN – Gordon  – Gordon, Nebraska
KGRR (GRR) – Gerald R. Ford Int'l – Grand Rapids, Michigan
KGSB (GSB) – Seymour Johnson Air Force Base – Goldsboro, North Carolina
KGSO (GSO) – Piedmont Triad Int'l  – Greensboro, North Carolina
KGSP (GSP) – Greenville-Spartanburg Int'l – Greer, South Carolina
KGSW – Greater Southwest Int'l – Fort Worth, Texas (closed 1970s)
KGTB (GTB) – Wheeler-Sack Army  – Fort Drum, New York
KGTE – Gothenburg  – Gothenburg, Nebraska
KGTF (GTF) – Great Falls Int'l  – Great Falls, Montana
KGTG – Grantsburg  – Grantsburg, Wisconsin
KGTR – Golden Triangle  – Columbus, Mississippi
KGTU – Georgetown  – Georgetown, Texas
KGUC (GUC) – Gunnison County  – Gunnison, Colorado
KGUP (GUP) – Gallup  – Gallup, New Mexico
KGUS (GUS) – Grissom Air Reserve Base – Peru, Indiana
KGUY - Guymon  - Guymon, Oklahoma
KGVE – Gordonsville  – Gordonsville, Virginia
KGVQ – Genesee County  – Batavia, New York
KGVT – Majors  – Greenville, Texas
KGWB – DeKalb County  – Auburn, Indiana
KGWO (GWO) – Greenwood-Leflore  – Greenwood, Mississippi
KGWR – Gwinner-Roger Melroe Field (Gwinner ) – Gwinner, North Dakota
KGWS – Glenwood Springs  – Glenwood Springs, Colorado
KGWW (GWW) – Goldsboro-Wayne  – Goldsboro, North Carolina
KGXA - Gray Butte Field - Lake Los Angeles, California
KGXY – Greeley-Weld County  – Greeley, Colorado
KGYB – Giddings-Lee County  – Giddings, Texas
KGYH – Donaldson Center  – Greenville, South Carolina
KGYI (GYI) – North Texas  (Perrin Field) – Denison, Texas
KGYR – Phoenix Goodyear  – Goodyear, Arizona
KGYY (GYY) – Gary/Chicago Int'l  – Gary, Indiana
KGZH – Middleton Field – Evergreen, Alabama
KGZL - Stigler  - Stigler, Oklahoma
KHAB – Marion County – Rankin Fite – Hamilton, Alabama
KHAE (HAE) – Hannibal  (William P. Lear Field) – Hannibal, Missouri
KH

KHAF – Half Moon Bay  (Eddie Andreini Sr. ) – Half Moon Bay, California
KHAI (HAI) – Three Rivers/Doctor Haines – Three Rivers, Michigan
KHAO (HAO) – Butler County  (Hogan Field) – Hamilton, Ohio
KHAR – Harford  – Casper, Wyoming
KHBC – Mohall  – Mohall, North Dakota
KHBG – Hattiesburg Bobby L. Chain – Hattiesburg, Mississippi
KHBI – Asheboro  – Asheboro, North Carolina
KHBR - Hobart  - Hobart, Oklahoma
KHBZ – Heber Springs  – Heber Springs, Arkansas
KHCD – Hutchinson  (Butler Field) – Hutchinson, Minnesota
KHDE – Brewster Field – Holdrege, Nebraska
KHDN (HDN) – Yampa Valley  – Hayden, Colorado
KHDO (HDO) – South Texas  at Hondo – Hondo, Texas
KHEE – Thompson-Robbins  – Helena, Arkansas
KHEF – Manassas  (Harry P. Davis Field) – Manassas, Virginia
KHEG – Herlong Recreational  – Jacksonville, Florida
KHEI – Hettinger  – Hettinger, North Dakota
KHEQ – Holyoke  – Holyoke, Colorado
KHEY (HEY) – Hanchey Army Heliport – Fort Rucker / Ozark, Alabama
KHEZ – Natchez-Adams County  (Hardy-Anders Field) – Natchez, Mississippi
KHFD (HFD) – Hartford-Brainard  – Hartford, Connecticut
KHFF – Mackall Army  – Camp Mackall, North Carolina
KHGR (HGR) – Hagerstown  – Hagerstown, Maryland
KHHF - Hemphill County  - Canadian, Texas
KHHR (HHR) – Hawthorne  (Jack Northrop Field) – Hawthorne, California
KHHW - Stan Stamper  - Hugo, Oklahoma
KHIE – Mount Washington  – Whitefield, New Hampshire
KHIF (HIF) – Hill Air Force Base – Ogden, Utah
KHII – Lake Havasu City  – Lake Havasu City, Arizona
KHIO – Hillsboro  – Portland, Oregon
KHJH – Hebron  – Hebron, Nebraska
KHJO (HJO) – Hanford  – Hanford, California
KHKA – Blytheville  – Blytheville, Arkansas
KHKS – Hawkins Field – Jackson, Mississippi
KHKY (HKY) – Hickory  – Hickory, North Carolina
KHLC – Hill City  – Hill City, Kansas
KHLG – Wheeling-Ohio County  – Wheeling, West Virginia
KHLN (HLN) – Helena  – Helena, Montana
KHLR (HLR) – Hood Army  – Fort Hood / Killeen, Texas
KHLX – Twin County  – Galax-Hillsville, Virginia
KHMN (HMN) – Holloman Air Force Base – Alamogordo, New Mexico
KHMS - Richland  - Richland, Washington
KHMT – Hemet-Ryan  – Hemet, California
KHMZ – Bedford County  – Bedford, Pennsylvania
KHND (HSH) – Henderson Executive  – Henderson, Nevada
KHNZ – Henderson-Oxford  – Oxford, North Carolina
KHOB (HOB) – Lea County  – Hobbs, New Mexico
KHOE – Homerville  – Homerville, Georgia
KHON (HON) – Huron  – Huron, South Dakota
KHOP (HOP) – Campbell Army  – Fort Campbell, Kentucky
KHOT (HOT) – Memorial Field  – Hot Springs, Arkansas
KHOU (HOU) – William P. Hobby  – Houston, Texas
KHPN (HPN) – Westchester County  – White Plains, New York
KHQG – Hugoton  – Hugoton, Kansas
KHQM (HQM) – Bowerman  – Hoquiam, Washington
KHQU – Thomson-McDuffie County  – Thomson, Georgia
KHQZ (HQZ) – Mesquite Metro  – Mesquite, Texas
KHRI – Hermiston  – Hermiston, Oregon
KHRJ (HRJ) – Harnett Regional Jetport – Erwin, North Carolina
KHRL (HRL) – Valley Int'l  – Harlingen, Texas
KHRO (HRO) – Boone County  – Harrison, Arkansas
KHRU (HRU) – Herington  – Herington, Kansas
KHRX - Hereford  - Hereford, Texas
KHSA – Stennis Int'l  – Bay St. Louis, Mississippi
KHSE – Billy Mitchell  – Hatteras, North Carolina
KHSI – Hastings  – Hastings, Nebraska
KHSP (HSP) – Ingalls Field – Hot Springs, Virginia
KHSR – Hot Springs  – Hot Springs, South Dakota
KHST (HST) – Homestead Air Reserve Base – Homestead, Florida
KHSV (HSV) – Huntsville Int'l  (Carl T. Jones Field) – Huntsville, Alabama
KHTH (HTH) – Hawthorne Industrial  – Hawthorne, Nevada
KHTO – East Hampton  – East Hampton, New York
KHTS (HTS) – Tri-State  – Huntington, West Virginia
KHUA (HUA) – Redstone Army  – Redstone Arsenal / Huntsville, Alabama
KHUF (HUF) – Terre Haute Int'l  – Terre Haute, Indiana
KHUL – Houlton Int'l  – Houlton, Maine
KHUM – Houma-Terrebonne  – Houma, Louisiana
KHUT (HUT) – Hutchinson  – Hutchinson, Kansas
KHVC – Hopkinsville-Christian County – Hopkinsville, Kentucky
KHVE – Hanksville  – Hanksville, Utah
KHVN (HVN) – Tweed-New Haven  – New Haven, Connecticut
KHVR – Havre City County  – Havre, Montana
KHVS – Hartsville  – Hartsville, South Carolina
KHWD (HWD) – Hayward Executive  – Hayward, California
KHWO – North Perry  – Hollywood, Florida
KHWQ – Wheatland County  – Harlowton, Montana
KHWV – Brookhaven  – Shirley, New York
KHWY (HWY) – Warrenton-Fauquier  – Warrenton, Virginia
KHXD – Hilton Head  – Hilton Head Island, South Carolina
KHXF – Hartford  – Hartford, Wisconsin
KHYA (HYA) – Barnstable  – Hyannis, Massachusetts
KHYI – San Marcos  – San Marcos, Texas
KHYR – Sawyer County  – Hayward, Wisconsin
KHYS (HYS) – Hays  – Hays, Kansas
KHYW – Conway-Horry County  – Conway, South Carolina
KHYX – Saginaw County H.W. Browne  – Saginaw, Michigan
KHZE – Mercer County  – Hazen, North Dakota
KHZL – Hazleton  – Hazleton, Pennsylvania
KIAB (IAB) – McConnell Air Force Base – Wichita, Kansas
KIAD (IAD) – Washington Dulles Int'l – Dulles, Virginia
KIAG (IAG) – Niagara Falls Int'l  – Niagara Falls, New York
KIAH (IAH) – George Bush Intercontinental – Houston, Texas
KIBM – Kimball  (Robert E. Arraj Field) – Kimball, Nebraska
KICR (ICR) – Winner  (Bob Wiley Field) – Winner, South Dakota
KICT (ICT) – Wichita Dwight D. Eisenhower National – Wichita, Kansas
KIDA (IDA) – Idaho Falls  – Idaho Falls, Idaho
KI

KIDI – Indiana County-Jimmy Stewart – Indiana, Pennsylvania
KIDL – Indianola  – Indianola, Mississippi
KIDP – Independence  – Independence, Kansas
KIEN - Pine Ridge  - Pine Ridge, South Dakota
KIFP (IFP) – Laughlin/Bullhead Int'l – Bullhead City, Arizona
KIGM (IGM) – Kingman  – Kingman, Arizona
KIGX – Horace Williams  – Chapel Hill, North Carolina
KIIB – Independence  – Independence, Iowa
KIIY – Washington-Wilkes County  – Washington, Georgia
KIJD – Windham  – Willimantic, Connecticut
KIJX – Jacksonville  - Jacksonville, Illinois
KIKV (IKV) – Ankeny  – Ankeny, Iowa
KIKW (IKW) – Jack Barstow  – Midland, Michigan
KILE (ILE) – Skylark Field – Killeen, Texas
KILG (ILG) – Wilmington  – Wilmington, Delaware
KILM (ILM) – Wilmington Int'l  – Wilmington, North Carolina
KILN (ILN) – Wilmington Air Park – Wilmington, Ohio
KIML – Imperial  – Imperial, Nebraska
KIMM (IMM) – Immokalee  – Immokalee, Florida
KIMS – Madison  – Madison, Indiana
KIND (IND) – Indianapolis Int'l  – Indianapolis, Indiana
KINJ (INJ) – Hillsboro  – Hillsboro, Texas
KINK - Winkler County  - Kermit, Texas
KINS – Creech Air Force Base – Indian Springs, Nevada
KINT (INT) – Smith Reynolds  – Winston-Salem, North Carolina
KINW (INW) – Winslow-Lindbergh  – Winslow, Arizona
KIOW – Iowa City  – Iowa City, Iowa
KIPJ – Lincolnton-Lincoln County – Lincolnton, North Carolina
KIPL – Imperial County  – Imperial, California
KIPT (IPT) – Williamsport  – Williamsport, Pennsylvania
KISM (ISM) – Kissimmee Gateway  – Kissimmee, Florida
KISN – Sloulin Field Int'l  – Williston, North Dakota
KISO – Kinston Regional Jetport (Stallings Field) – Kinston, North Carolina
KISP (ISP) – Long Island MacArthur  – Islip, New York
KISW – South Wood County  (Alexander Field) – Wisconsin Rapids, Wisconsin
KITH (ITH) – Ithaca Tompkins  – Ithaca, New York
KITR – Kit Carson County  – Burlington, Colorado
KIWA (AZA) – Phoenix-Mesa Gateway  – Mesa, Arizona
KIWI – Wiscasset  – Wiscasset, Maine
KIXD – New Century AirCenter – Olathe, Kansas
KIYK – Inyokern  – Inyokern, California
KIZA – Santa Ynez  – Santa Ynez, California
KIZG – Eastern Slopes  (Fryeburg ) – Fryeburg, Maine
KJAC (JAC) – Jackson Hole  – Jackson Hole, Wyoming
KJAN (JAN) – Jackson Int'l  – Jackson, Mississippi
KJAX (JAX) – Jacksonville Int'l  – Jacksonville, Florida
KJBR (JBR) – Jonesboro  – Jonesboro, Arkansas
KJCT - Kimble County  - Junction, Texas
KJDN – Jordan  – Jordan, Montana
KJEF – Jefferson City Memorial  – Jefferson City, Missouri
KJFK (JFK) – John F. Kennedy Int'l  – New York, New York
KJ

KJFX – Walker County  (Bevill Field) – Jasper, Alabama
KJER – Jerome County  – Jerome, Idaho
KJGG – Williamsburg-Jamestown  – Williamsburg, Virginia
KJHN – Stanton County  – Johnson, Kansas
KJHW – Chautauqua County-Jamestown – Jamestown, New York
KJKA (GUF) – Jack Edwards  – Gulf Shores, Alabama
KJMS (JMS) – Jamestown  – Jamestown, North Dakota
KJNX – Johnston  – Smithfield, North Carolina
KJQF (JQF) – Concord  – Concord, North Carolina
KJRA – West 30th Street Heliport – Manhattan, New York City, New York
KJRB (JRB) – Downtown Manhattan Heliport – Manhattan, New York City, New York
KJST (JST) – Johnstown-Cambria County  – Johnstown, Pennsylvania
KJSV - Sallisaw  - Sallisaw, Oklahoma
KJVW – John Bell Williams  – Raymond, Mississippi
KJWG - Watonga  - Watonga, Oklahoma
KJWN - John C. Tune  - Nashville, Tennessee
KJYO (JYO) – Leesburg Executive  (Godfrey Field) – Leesburg, Virginia
KJYR – York  – York, Nebraska
KJZI – Charleston Executive  – Charleston, South Carolina
KJZP – Pickens County  – Jasper, Georgia
KKIC – Mesa Del Rey  – King City, California
KKLS (KLS) – Southwest Washington  (was Kelso-Longview) – Kelso, Washington
KKNB (KNB) – Kanab  – Kanab, Utah
KKY8 (KY8) - Hancock County  - [Lewisport, Kentucky]]
KLAA – Lamar  – Lamar, Colorado
KLAF (LAF) – Purdue University  – West Lafayette, Indiana
KLAL (LAL) – Lakeland Linder Int'l – Lakeland, Florida
KLAM – Los Alamos  – Los Alamos, New Mexico
KLAN (LAN) – Capital Region Int'l – Lansing, Michigan
KLAR (LAR) – Laramie  – Laramie, Wyoming
KLAS (LAS) – McCarran Int'l  – Las Vegas, Nevada
KLAW - Lawton-Fort Sill  - Lawton, Oklahoma
KLAX (LAX) – Los Angeles Int'l  – Los Angeles, California
KLBB (LBB) – Lubbock Preston Smith Int'l – Lubbock, Texas
KLBE (LBE) – Arnold Palmer  – Latrobe, Pennsylvania
KLBF (LBF) – North Platte  (Lee Bird Field) – North Platte, Nebraska
KLBL (LBL) – Liberal  – Liberal, Kansas
KLBR (LBR) – Clarksville/Red River County (J.D. Trissell Field) – Clarksville, Texas
KLBT – Lumberton  – Lumberton, North Carolina
KLCG – Wayne  (Stan Morris Field) – Wayne, Nebraska
KLCK (LCK) – Rickenbacker Int'l  – Columbus, Ohio
KLCH (LCH) – Lake Charles  – Lake Charles, Louisiana
KLCI – Laconia  – Laconia, New Hampshire
KLCQ – Lake City Gateway  – Lake City, Florida
KLDJ – Linden  – Linden, New Jersey
KLDM (LDM) – Mason County  – Ludington, Michigan
KLEB (LEB) – Lebanon  – West Lebanon, New Hampshire
KLEE (LEE) – Leesburg Int'l  – Leesburg, Florida
KLEM – Lemmon  – Lemmon, South Dakota
KLEW – Auburn/Lewiston  – Auburn, Maine
KLEX – Blue Grass  – Lexington, Kentucky
KLFI – Langley Air Force Base – Hampton, Virginia
KLFK – Angelina County  – Lufkin, Texas
KLFT – Lafayette  (Paul Fournet Field) – Lafayette, Louisiana
KLGA – La Guardia Int'l  – New York, New York
KLGB – Long Beach  – Long Beach, California
KLGD – La Grande/Union County  – La Grande, Oregon
KLGF (LGF) – Laguna Army  (Yuma Proving Ground) – Yuma, Arizona
KLGU – Logan-Cache  – Logan, Utah
KLHB – Hearne  – Hearne, Texas
KLHM – Lincoln  (Karl Harder Field) – Lincoln, California
KLHQ – Fairfield County  – Lancaster, Ohio
KLHV – William T. Piper Memorial  – Lock Haven, Pennsylvania
KLHX – La Junta  – La Junta, Colorado
KLHZ – Triangle North Executive  (Franklin County ) – Louisburg, North Carolina
KLIC – Limon  – Limon, Colorado
KLIT – Bill and Hillary Clinton National (Adams Field) – Little Rock, Arkansas
KLKP – Lake Placid  – Lake Placid, New York
KLKR – Lancaster County  (McWhirter Field) – Lancaster, South Carolina
KLKU – Louisa County  (Freeman Field) – Louisa, Virginia
KLKV – Lake County  – Lakeview, Oregon
KLLJ – Challis  – Challis, Idaho
KLLQ – Monticello  (Ellis Field) – Monticello, Arkansas
KLLU – Lamar  – Lamar, Missouri
KLMO – Vance Brand  – Longmont, Colorado
KLMS – Louisville Winston County  – Louisville, Mississippi
KLMT – Crater Lake-Klamath – Klamath Falls, Oregon
KLNA – Palm Beach County Park  (Lantana ) – West Palm Beach, Florida
KLNC – Lancaster  – Lancaster, Texas
KLND – Hunt Field – Lander, Wyoming
KLNK – Lincoln  – Lincoln, Nebraska
KLNN – Lost Nation  – Willoughby, Ohio
KLNP – Lonesome Pine  – Wise, Virginia
KLNS – Lancaster  – Lancaster, Pennsylvania
KLOL – Derby Field – Lovelock, Nevada
KLOR (LOR) – Lowe Army Heliport – Fort Rucker / Ozark, Alabama
KLOT (LOT) – Lewis University  – Romeoville, Illinois
KLOU – Bowman Field – Louisville, Kentucky
KLOZ – London-Corbin  (Magee Field) – London, Kentucky
KLPC – Lompoc  – Lompoc, California
KLPR – Lorain County  – Lorain, Ohio
KLQK – Pickens County  – Pickens, South Carolina
KLQR – Larned-Pawnee County  – Larned, Kansas
KLRD (LRD) – Laredo Int'l  – Laredo, Texas
KLRF – Little Rock Air Force Base – Jacksonville, Arkansas
KLRG – Lincoln  – Lincoln, Maine
KLRU – Las Cruces Int'l  – Las Cruces, New Mexico
KLSB – Lordsburg  – Lordsburg, New Mexico
KLSE (LSE) – La Crosse  – La Crosse, Wisconsin
KLSF – Lawson Army  – Fort Benning, Chattahoochee County, Georgia
KLSK – Lusk  – Lusk, Wyoming
KLSN – Los Banos  – Los Banos, California
KLSV (LSV) – Nellis Air Force Base – Las Vegas, Nevada
KLTS – (LTS) Altus Air Force Base – Altus, Oklahoma
KLTY – Liberty County  – Chester, Montana
KLUF (LUF) – Luke Air Force Base – Glendale, Arizona
KLUG – Ellington  – Lewisburg, Tennessee
KLUL – Hesler-Noble Field – Laurel, Mississippi
KLVK – Livermore  – Livermore, California
KLVL – Lawrenceville/Brunswick – Lawrenceville, Virginia
KLVM – Mission Field – Livingston, Montana
KLVN – Airlake  – Lakeville, Minnesota
KLVS (LVS) – Las Vegas  – Las Vegas, New Mexico
KLWB – Greenbrier Valley  – Lewisburg, West Virginia
KLWC – Lawrence  – Lawrence, Kansas
KLWL – Wells  (Harriet Field) – Wells, Nevada
KLWM – Lawrence  – Lawrence, Massachusetts
KLWS – Lewiston-Nez Perce County  – Lewiston, Idaho
KLWT – Lewistown  – Lewistown, Montana
KLWV – Lawrenceville-Vincennes Int'l  – Lawrenceville, Illinois
KLXL – Little Falls/Morrison County  (Lindbergh Field) – Little Falls, Minnesota
KLXN – Jim Kelly Field – Lexington, Nebraska
KLXT – Lee's Summit  – Lee's Summit, Missouri
KLXV – Lake County  (Leadville ) – Leadville, Colorado
KLYH – Lynchburg  – Lynchburg, Virginia
KLYO – Lyons-Rice County  – Lyons, Kansas
KLZU – Gwinnett County  (Briscoe Field) – Lawrenceville, Georgia
KLZZ – Lampasas  – Lampasas, Texas
KMAC – Macon Downtown  (Herbert Smart Downtown ) –M acon, Georgia
KMAE – Madera  – Madera, California
KMAF (MAF) – Midland Int'l Air and Space Por t– Midland, Texas
KMAI – Marianna  – Marianna, Florida
KMAL – Malone-Dufort  – Malone, New York
KMAN - Nampa  - Nampa, Idaho
KMAO – Marion County  – Marion, South Carolina
KMAW – Malden  – Malden, Missouri
KMBG – Mobridge  – Mobridge, South Dakota
KMBO – Campbell  – Madison, Mississippi
KMBS (MBS) – MBS Int'l  – Midland / Bay City / Saginaw, Michigan
KMBT (MBT) – Murfreesboro  – Murfreesboro, Tennessee
KMCB (MCB) – McComb-Pike County  (John E. Lewis Field) – McComb, Mississippi
KMCC (MCC) – McClellan  – Sacramento, California
KMCE – Merced  (MacReady Field) – Merced, California
KMCF (MCF) – MacDill Air Force Base – Tampa, Florida
KMCI (MCI) – Kansas City Int'l  – Kansas City, Missouri
KMCK (MCK) – McCook Ben Nelson – McCook, Nebraska
KMCN (MCN) – Middle Georgia  – Macon, Georgia
KMCO (MCO) – Orlando Int'l  – Orlando, Florida
KMCW – Mason City  – Mason City, Iowa
KMCZ – Martin County  – Williamston, North Carolina
KMDD - Midland Airpark - Midland, Texas
KMDQ – Madison County Executive  (Tom Sharp Jr. Field) – Huntsville, Alabama
KMDS – Madison  – Madison, South Dakota
KMDT (MDT) – Harrisburg Int'l  – Middletown, Pennsylvania
KM

KMDW (MDW) – Chicago Midway Int'l – Chicago, Illinois
KMDZ – Taylor County  – Medford, Wisconsin
KMEB – Laurinburg-Maxton  – Maxton, North Carolina
KMEI (MEI) – Key Field – Meridian, Mississippi
KMEJ – Meade  – Meade, Kansas
KMEM (MEM) – Memphis Int'l  – Memphis, Tennessee
KMER (MER) – Castle  – Atwater, California
KMEV – Minden-Tahoe  – Minden, Nevada
KMFE (MFE) – McAllen-Miller Int'l  – McAllen, Texas
KMFI – Marshfield  (Wisconsin) – Marshfield, Wisconsin
KMFR (MFR) – Rogue Valley Int'l-Medford  – Medford, Oregon
KMFV – Accomack County  – Melfa, Virginia
KMGE (MGE) – Dobbins Air Reserve Base (General Lucius D. Clay National Guard Center) –M arietta, Georgia
KMGG – Maple Lake  – Maple Lake, Minnesota
KMGJ – Orange County  – Montgomery, New York
KMGM (MGM) – Montgomery  (Dannelly Field) – Montgomery, Alabama
KMGW (MGW) – Morgantown  – Morgantown, West Virginia
KMGY (MGY) – Dayton Wright Brothers  – Dayton, Ohio
KMHE – Mitchell  – Mitchell, South Dakota
KMHK (MHK) – Manhattan  – Manhattan, Kansas
KMHL – Marshall Memorial – Marshall, Missouri
KMHN – Hooker County  – Mullen, Nebraska
KMHR (MHR) – Sacramento Mather  – Sacramento, California
KMHS - Dunsmuir-Mott  - Mount Shasta, California
KMHT (MHT) – Manchester-Boston – Manchester, New Hampshire
KMHV – Mojave Air and Space Port (Civilian Aerospace Test Center) – Mojave, California
KMIA (MIA) – Miami Int'l  – Miami, Florida
KMIB (MIB) – Minot Air Force Base – Minot, North Dakota
KMIC – Crystal  – Crystal, Minnesota
KMIO – Miami  – Miami, Oklahoma
KMIT – Shafter  (Minter Field) – Shafter, California
KMIV (MIV) – Millville  – Millville, New Jersey
KMJX – Robert J. Miller Air Park (Ocean County ) – Toms River, New Jersey
KMKA – Miller  – Miller, South Dakota
KMKE (MKE) – General Mitchell Int'l – Milwaukee, Wisconsin
KMKJ – Mountain Empire  – Marion / Wytheville, Virginia
KMKL (MKL) – McKellar-Sipes  – Jackson, Tennessee
KMKO - Davis Field - Muskogee, Oklahoma
KMKT (MKT) – Mankato  – Mankato, Minnesota
KMKY – Marco Island  – Naples, Florida
KMLB (MLB) – Orlando Melbourne Int'l – Melbourne, Florida
KMLC - McAlester  - McAlester, Oklahoma
KMLD – Malad City  – Malad City, Idaho
KMLE - Millard  - Omaha, Nebraska
KMLF (MLF) – Milford  (Ben and Judy Briscoe Field) – Milford, Utah
KMLI (MLI) – Quad City Int'l  – Moline, Illinois
KMLS (MLS) – Miles City  – Miles City, Montana
KMLT – Millinocket  – Millinocket, Maine
KMLU (MLU) – Monroe  – Monroe, Louisiana
KMMH – Mammoth Yosemite  – Mammoth Lakes, California
KMMI – McMinn County  – Athens, Tennessee
KMMK – Meriden Markham  – Meriden, Connecticut
KMMS – Selfs  – Marks, Mississippi
KMMT – McEntire Joint National Guard Base – Eastover, South Carolina
KMMU (MMU) – Morristown  – Morristown, New Jersey
KMMV (MMV) – McMinnville  – McMinnville, Oregon
KMNI – Santee Cooper  – Manning, South Carolina
KMNZ – Hamilton  – Hamilton, Texas
KMOB (MOB) – Mobile  – Mobile, Alabama
KMOD (MOD) – Modesto City-County  – Modesto, California
KMOR – Morristown  – Morristown, Tennessee
KMOT (MOT) – Minot Int'l  – Minot, North Dakota
KMPE – Philadelphia  – Philadelphia, Mississippi
KMPI (MPI) – Mariposa-Yosemite  – Mariposa, California
KMPJ – Petit Jean Park  – Morrilton, Arkansas
KMPO – Pocono Mountains – Mount Pocono, Pennsylvania
KMPR – McPherson  – McPherson, Kansas
KMPV – Edward F. Knapp State  – Barre-Montpelier, Vermont
KMQI – Dare County  – Manteo, North Carolina
KMQJ (MQJ) – Indianapolis  (Mount Comfort ) – Indianapolis, Indiana
KMQS – Chester County G. O. Carlson – Coatesville, Pennsylvania
KMQY (MQY) – Smyrna  – Smyrna, Tennessee
KMRB (MRB) – Eastern West Virginia  (Shepherd Field) – Martinsburg, West Virginia
KMRF - Marfa  - Marfa, Texas
KMRH – Michael J. Smith Field – Beaufort, North Carolina
KMRN (MRN) – Foothills  – Morganton, North Carolina
KMRY (MRY) – Monterey  – Monterey, California
KMSL (MSL) – Northwest Alabama – Muscle Shoals, Alabama
KMSN (MSN) – Dane County  – Madison, Wisconsin
KMSO (MSO) – Missoula Int'l  – Missoula, Montana
KMSP (MSP) – Minneapolis-Saint Paul Int'l – Bloomington, Minnesota
KMSS (MSS) – Massena Int'l  – Massena, New York
KMSV – Sullivan County Int'l – Monticello, New York
KMSY (MSY) – Louis Armstrong New Orleans Int'l – New Orleans, Louisiana
KMTC (MTC) – Selfridge Air National Guard Base – Mt. Clemens, Michigan
KMTH (MTH) – Florida Keys Marathon  – Marathon, Florida
KMTJ – Montrose  – Montrose, Colorado
KMTN (MTN) – Martin State  – Baltimore, Maryland
KMTP (MTP) – Montauk  – Montauk, New York
KMTV – Blue Ridge  – Martinsville, Virginia
KMTW – Manitowoc County  – Manitowoc, Wisconsin
KMUO (MUO) – Mountain Home Air Force Base – Mountain Home, Idaho
KMUT – Muscatine  – Muscatine, Iowa
KMUU – Huntingdon County  – Mount Union, Pennsylvania (closed)
KMVC (MVC) – Monroe County  – Monroeville, Alabama
KMVI – Monte Vista  – Monte Vista, Colorado
KMVL – Morrisville-Stowe State  – Morrisville, Vermont
KMVM – Machias Valley  – Machias, Maine
KMVY (MVY) – Martha's Vineyard  – Vineyard Haven, Massachusetts
KMWH – Grant County Int'l  – Moses Lake, Washington
KMWK – Mount Airy/Surry County  – Mount Airy, North Carolina
KMWL – Mineral Wells  – Mineral Wells, Texas
KMXA – Manila  – Manila, Arkansas
KMXF (MXF) – Maxwell Air Force Base – Montgomery, Alabama
KMXO – Monticello  – Monticello, Iowa
KMYF – Montgomery-Gibbs Executive – San Diego, California
KMYL – McCall  – McCall, Idaho
KMYR (MYR) – Myrtle Beach Int'l  – Myrtle Beach, South Carolina
KMYV (MYV) – Yuba County  – Marysville, California
KMYZ – Marysville  – Marysville, Kansas
KMZJ (MZJ) – Pinal Airpark – Marana, Arizona
KNAB – Naval Air Station Albany – Albany, Georgia
KNBC (BFT) – Marine Corps Air Station Beaufort – Beaufort, South Carolina
KNBJ (NHX) – Naval Outlying Field Barin – Foley, Alabama
KNCA (NCA) – Marine Corps Air Station New River – Jacksonville, North Carolina
KNDY – Naval Surface Warfare Center Dahlgren – Dahlgren, Virginia
KNEL (NEL) – Naval Air Engineering Station Lakehurs t– Lakehurst, New Jersey
KNEN – Naval Outlying Field Whitehouse – Jacksonville, Florida
KNEW (NEW) – Lakefront  – New Orleans, Louisiana
KNFD – Naval Outlying Field Summerdale – Summerdale, Alabama
KNFE – Naval Auxiliary Landing Field Fentress – Chesapeake, Virginia
KNFG (NFG) – Marine Corps Air Station Camp Pendleton – Camp Pendleton, California
KNFJ – Naval Outlying Field Choctaw – Milton, Florida
KNFL (NFL) – Naval Air Station Fallon – Fallon, Nevada
KNFW – Naval Air Station Joint Reserve Base Fort Worth – Fort Worth, Texas
KNGP (NGP) – Naval Air Station Corpus Christ i– Corpus Christi, Texas
KNGS – Naval Outlying Field Santa Rosa – Milton, Florida
KNGU (NGU) – Naval Station Norfolk – Norfolk, Virginia
KNGZ – Naval Air Station Alameda – Alameda, California
KNHK (NHK) – Naval Air Station Patuxent River – Patuxent River, Maryland
KNHL – Naval Outlying Field Wolf – Foley, Alabama
KNHZ – Naval Air Station Brunswick – Brunswick, Maine (converted to civilian use see KBXM)
KNID – Naval Air Weapons Station China Lake – Ridgecrest, California
KNIP (NIP) – Naval Air Station Jacksonville – Jacksonville, Florida
KNJK (NJK) – Naval Air Facility El Centro – El Centro, California
KNJM – Marine Corps Auxiliary Landing Field Bogue – Swansboro, North Carolina
KNJW – Naval Outlying Field Joe Williams – Meridian, Mississippi
KNKL – Naval Outlying Field Holley – Fort Walton Beach, Florida
KNKT (NKT) – Marine Corps Air Station Cherry Poin t– Cherry Point, North Carolina
KNKX (NKX) – Marine Corps Air Station Miramar – San Diego, California
KNLC – Naval Air Station Lemoore – Lemoore, California
KNMM (NMM) – Naval Air Station Meridian – Meridian, Mississippi
KNOW – Coast Guard Air Station Port Angeles – Port Angeles, Washington
KNPA (NPA) – Naval Air Station Pensacola – Pensacola, Florida
KNPI – Naval Outlying Field Site 8 – Pensacola, Florida
KNQA (NQA) – Millington Regional Jetport – Millington, Tennessee
KNQB – Naval Outlying Field Silverhill – Robertsdale, Alabama
KNQX (NQX) – Naval Air Station Key West – Boca Chica Key, Florida
KNRA – Naval Outlying Field Coupeville – Coupeville, Washington
KNRB – Naval Station Mayport – Jacksonville, Florida
KNRN – Norton  – Norton, Kansas
KNRQ – Naval Outlying Field Spencer – Pace, Florida
KNRS – Naval Outlying Landing Field Imperial Beach – Imperial Beach, California
KNSI – Naval Outlying Field San Nicolas Island – San Nicolas Island, California
KNTD (NTD) – Naval Air Station Point Mugu – Oxnard, California
KNTK – Marine Corps Air Station Tustin – Santa Ana, California
KNTU (NTU) – Naval Air Station Oceana – Virginia Beach, Virginia
KNUC – Naval Auxiliary Landing Field San Clemente Island – San Clemente, California
KNUI – Naval Outlying Field Webster – Saint Inigoes, Maryland
KNUN – Naval Outlying Field Saufley – Pensacola, Florida
KNUQ (NUQ) – Moffett Federal  – Mountain View, California
KN

KNUW – Naval Air Station Whidbey Island – Oak Harbor, Washington
KNVI – Naval Outlying Field Pace – Wallace, Florida
KNWL – Naval Outlying Field Waldron – Corpus Christi, Texas
KNYG – Marine Corps Air Facility Quantico – Quantico, Virginia
KNYL (YUM) – Yuma Int'l  / Marine Corps Air Station Yuma – Yuma, Arizona
KNXF – Marine Corps Outlying Field (Red Beach) Camp Pendleton - Camp Pendleton, California
KNXP – Marine Corps Air Ground Combat Center Twentynine Palms – Twentynine Palms, California
KNXX – Naval Air Station Joint Reserve Base Willow Grove – Willow Grove, Pennsylvania
KNZJ – Marine Corps Air Station El Toro – Santa Ana, California
KNZY (NZY) – Naval Air Station North Island – San Diego, California
KOAJ – Albert J. Ellis  – Jacksonville, North Carolina
KOAK – Oakland Int'l  – Oakland, California
KOAR – Marina  – Marina, California
KOBE – Okeechobee County  – Okeechobee, Florida
KOBI – Woodbine  – Woodbine, New Jersey
KOCF – Ocala Int'l  (Jim Taylor Field) – Ocala, Florida
KOCH (OCH) – Nacogdoches A.L. Mangham Jr.  – Nacogdoches, Texas
KOCW – Washington–Warren  – Washington, North Carolina
KODO - Odessa-Schlemeyer Field - Odessa, Texas
KODX – Evelyn Sharp Field – Ord, Nebraska
KOEL – Oakley  – Oakley, Kansas
KOFF – Offutt Air Force Base – Omaha, Nebraska
KOFK – Norfolk  (Karl Stefan Memorial Field) – Norfolk, Nebraska
KOFP – Hanover County  – Richmond / Ashland, Virginia
KOGA – Searle Field – Ogallala, Nebraska
KOGB – Orangeburg  – Orangeburg, South Carolina
KOGD – Ogden-Hinckley  – Ogden, Utah
KOGS – Ogdensburg Int'l  – Ogdensburg, New York
KOIC – Lt. Warren Eaton  – Norwich, New York
KOIN – Oberlin  – Oberlin, Kansas
KOJA - Thomas P. Stafford  - Weatherford, Oklahoma
KOJC – Johnson County Executive  – Olathe, Kansas
KOKB – Oceanside  (Bob Maxwell Field) – Oceanside, California
KOKC (OKC) – Will Rogers World  – Oklahoma City, Oklahoma
KOKK – Kokomo  – Kokomo, Indiana
KOKM - Okmulgee  - Okmulgee, Oklahoma
KOKS – Garden County  – Oshkosh, Nebraska
KOKV – Winchester  – Winchester, Virginia
KOLD – Old Town  and Seaplane Base (Dewitt Field) – Old Town, Maine
KOLE – Cattaraugus County-Olean  – Olean, New York
KOLF – L. M. Clayton  – Wolf Point, Montana
KOLM – Olympia  – Olympia, Washington
KOLS (OLS) – Nogales Int'l  – Nogales, Arizona
KOLU – Columbus  – Columbus, Nebraska
KOLV – Olive Branch  – Olive Branch, Mississippi
KOLZ – Oelwein  – Oelwein, Iowa
KOMA – Eppley Field – Omaha, Nebraska
KOMH – Orange County  – Orange, Virginia
KOMK – Omak  – Omak, Washington
KOMN – Ormond Beach  – Ormond Beach, Florida
KONA – Winona  (Max Conrad Field) – Winona, Minnesota
KO

KONL – O'Neill  (John L. Baker Field) – O'Neill, Nebraska
KONO – Ontario  – Ontario, Oregon
KONP – Newport  – Newport, Oregon
KONT – Ontario Int'l  – Ontario, California
KONX – Currituck County  – Currituck, North Carolina
KOPF – Miami-Opa Locka Executive  – Opa-locka, Florida
KOPL – St. Landry Parish  (Ahart Field) – Opelousas, Louisiana
KOQN – Brandywine  – West Chester, Pennsylvania
KOQU (OQU) – Quonset State  – North Kingstown, Rhode Island
KORB – Orr  – Orr, Minnesota
KORD – O'Hare Int'l  – Chicago, Illinois
KORE – Orange  – Orange, Massachusetts
KORF – Norfolk Int'l  – Norfolk, Virginia
KORG – Orange County  – Orange, Texas
KORH – Worcester  – Worcester, Massachusetts
KORL – Orlando Executive  – Orlando, Florida
KORS – Orcas Island  – Eastsound, Washington
KOSH – Wittman  – Oshkosh, Wisconsin
KOSU – Ohio State University  (OSU Don Scott ) – Columbus, Ohio
KOSX – Kosciusko-Attala County  – Kosciusko, Mississippi
KOTH – Southwest Oregon  – North Bend, Oregon
KOTM – Ottumwa  – Ottumwa, Iowa
KOUN – University of Oklahoma Westheimer  – Norman, Oklahoma
KOVE – Oroville  – Oroville, California
KOVS – Boscobel  – Boscobel, Wisconsin
KOWB – Owensboro-Daviess County – Owensboro, Kentucky
KOWD – Norwood Memorial  – Norwood, Massachusetts
KOWI – Ottawa  – Ottawa, Kansas
KOWK – Central Maine  of Norridgewock – Norridgewock, Maine
KOXB (OCE) – Ocean City  – Ocean City, Maryland
KOXC – Waterbury-Oxford  – Oxford, Connecticut
KOXD – Miami University  – Oxford, Ohio
KOXR – Oxnard  – Oxnard, California
KOYM – St. Marys  – Saint Marys, Pennsylvania
KOZA - Ozona  - Ozona, Texas
KOZR (OZR) – Cairns Army  – Fort Rucker / Ozark, Alabama
KOZS (OZS) – Camdenton Memorial  – Camdenton, Missouri
KPAE – Snohomish County  (Paine Field) – Everett, Washington
KPAM – Tyndall AFB – Panama City, FL
KPAN (PJB) – Payson  – Payson, Arizona
KPAO – Palo Alto  – Palo Alto, California
KPBF – Grider Field – Pine Bluff, Arkansas
KPBG – Plattsburgh Int'l  – Plattsburgh, New York
KPBI – Palm Beach Int'l  – West Palm Beach, Florida
KPBX – Pike County  (Hatcher Field) – Pikeville, Kentucky
KPCM – Plant City  – Plant City, Florida
KPCU – Picayune-Pearl River County – Picayune, Mississippi
KPCZ – Waupaca  (Brunner Field) – Waupaca, Wisconsin
KPDC – Prairie du Chien  – Prairie du Chien, Wisconsin
KPDK – DeKalb-Peachtree  – Atlanta, Georgia
KPDT – Eastern Oregon  – Pendleton, Oregon
KP

KPDX – Portland Int'l  – Portland, Oregon
KPEO – Penn Yan  (Yates County ) – Penn Yan, New York
KPEQ - Pecos  - Pecos, Texas
KPFC – Pacific City State  – Pacific City, Oregon
KPFN – Panama City-Bay County Int'l – Panama City, FL (closed in 2010)
KPGA (PGA) – Page  – Page, Arizona
KPGD – Charlotte County  – Punta Gorda, Florida
KPGR – Kirk Field – Paragould, Arkansas
KPGV – Pitt-Greenville  – Greenville, North Carolina
KPHF – Newport News/Williamsburg Int'l – Newport News, Virginia
KPHG – Phillipsburg  – Phillipsburg, Kansas
KPHH – Robert F. Swinnie  – Andrews, South Carolina
KPHK – Palm Beach County Glades  – Pahokee, Florida
KPHL – Philadelphia Int'l  – Philadelphia, Pennsylvania
KPHP – Philip  – Philip, South Dakota
KPHT – Henry County  – Paris, Tennessee
KPHX (PHX) – Phoenix Sky Harbor Int'l – Phoenix, Arizona
KPIA – General Wayne A. Downing Peoria Int'l  – Peoria, Illinois
KPIB – Hattiesburg-Laurel  – Hattiesburg, Mississippi
KPIE – St. Pete-Clearwater Int'l – St. Petersburg, Florida
KPIH – Pocatello  – Pocatello, Idaho
KPIR – Pierre  – Pierre, South Dakota
KPIT – Pittsburgh Int'l  – Pittsburgh, Pennsylvania
KPKB – Mid-Ohio Valley  – Parkersburg, West Virginia
KPKV – Calhoun County  – Port Lavaca, Texas
KPLB (PLB) – Clinton County  – Plattsburgh, New York (closed)
KPLK – M. Graham Clark Downtown  – Point Lookout, Missouri
KPLR (PLR) – St. Clair County  – Pell City, Alabama
KPLU - Pierce County  (Thun Field) - Graham, Washington
KPMB – Pembina  – Pembina, North Dakota
KPMD – Palmdale  – Palmdale, California
KPMV – Plattsmouth  – Plattsmouth, Nebraska
KPMZ – Plymouth  – Plymouth, North Carolina
KPNA (PWY) – Ralph Wenz Field – Pinedale, Wyoming
KPNC - Ponca City  - Ponca City, Oklahoma
KPNE – Northeast Philadelphia  – Philadelphia, Pennsylvania
KPNM – Princeton  – Princeton, Minnesota
KPNN – Princeton  – Princeton, Maine
KPNS – Pensacola Int'l  – Pensacola, Florida
KPOB – Pope Field (military) – Fayetteville, North Carolina
KPOC – Brackett Field – La Verne, California
KPOU – Hudson Valley  (Poughkeepsie ) – Poughkeepsie, New York
KPOY – Powell  – Powell, Wyoming
KPPF – Tri-City  – Parsons, Kansas
KPQI – Northern Maine  at Presque Isle – Presque Isle, Maine
KPQL – Trent Lott Int'l  – Pascagoula, Mississippi
KPRB – Paso Robles  – Paso Robles, California
KPRC (PRC) – Prescott  (Ernest A. Love Field) – Prescott, Arizona
KPRN – Mac Crenshaw Memorial  – Greenville, Alabama
KPRX – Cox Field – Paris, Texas
KPSB – Mid-State  – Philipsburg, Pennsylvania
KPSC – Tri-Cities  – Pasco, Washington
KPSF – Pittsfield  – Pittsfield, Massachusetts
KPSK – New River Valley  – Dublin, Virginia
KPSM – Portsmouth Int'l  at Pease – Portsmouth, New Hampshire
KPSO – Stevens Field – Pagosa Springs, Colorado
KPSP – Palm Springs Int'l  – Palm Springs, California
KPTB – Dinwiddie County  – Petersburg, Virginia
KPTD – Potsdam  (Damon Field) – Potsdam, New York
KPTN – Harry P. Williams Memorial  – Patterson, Louisiana
KPTS – Atkinson  – Pittsburg, Kansas
KPTT – Pratt  – Pratt, Kansas
KPTV – Porterville  – Porterville, California
KPTW – Heritage Field – Pottstown, Pennsylvania
KPUB – Pueblo Memorial  – Pueblo, Colorado
KPUC – Carbon County  (Buck Davis Field) – Price, Utah
KPUJ – Silver Comet Field at Paulding Northwest Atlanta Airpo r–t Dallas, Georgia
KPUW – Pullman-Moscow  – Pullman, Washington
KPVB – Platteville  – Platteville, Wisconsin
KPVC – Provincetown  – Provincetown, Massachusetts
KPVD – T.F. Green State  – Providence, Rhode Island
KPVE – Beech River  – Darden, Tennessee
KPVF – Placerville  – Placerville, California
KPVG – Hampton Roads Executive  – Chesapeake, Virginia
KPVJ - Pauls Valley  - Pauls Valley, Oklahoma
KPVU – Provo  – Provo, Utah
KPVW - Hale County  - Plainview, Texas
KPWA - Wiley Post  - Oklahoma City, Oklahoma
KPWD – Sher-Wood  – Plentywood, Montana
KPWK – Chicago Executive  (formerly PalWaukee) – Wheeling, Illinois
KPWM – Portland Int'l Jetport – Portland, Maine
KPWT – Bremerton National  – Bremerton, Washington
KPXE – Perry-Houston County  – Perry, Georgia
KPYG – Pageland  – Pageland, South Carolina
KPYM – Plymouth  – Plymouth, Massachusetts
KPYP – Centre-Piedmont-Cherokee County Regional Airpor –t Centre, Alabama
KPYX – Perryton Ochiltree County  - Perryton, Texas
(METAR weather station sites operated by the U.S. Department of Defense)
KQA7 – Tarin Kowt, Afghanistan
KQAD – FOB Echo, Al Diwaniyah, Iraq
KQAE – al Musayyib FOB, Iraq
KQAJ – Al Asad AB, Iraq
KQAQ – Camp Taji, Iraq
KQAX – Camp Victory (BIAP), Iraq
KQAY – Patton AAF, Camp Arifjan, Kuwait
KQCO – FOB Q-West (Al-Qayyarah), Iraq
KQCT – Ar Ramadi, Iraq
KQCU – Fort Chaffee, Arkansas
KQD9 – FOB Salerno, Khost, Afghanistan
KQDM – Orgun, Afghanistan
KQEZ – Al Taqaddum AB, Iraq
KQGV – Ali Al Salem AB, Kuwait
KQGX – Al Dhafra AB, United Arab Emirates
KQIR – Al Udeid AB, Qatar
KQIU – Fire Base Lilley, Shkin, Afghanistan
KQL5 – Jalalabad, Afghanistan
KQ

KQMA – Camp Fallujah, Iraq
KQMG – Mudaysis, Iraq
KQMH – Camp Korean Village (KV) (Ar Rutbah), Iraq
KQNC – Souda Bay AB, Greece
KQNN – Naples, Italy
KQNS – NAS Sigonella, Italy
KQNT – NAS Keflavik, Iceland
KQNY – Camp Ramadi, Iraq
KQOS – Oscura Range, New Mexico
KQPC – Camp Gannon (Husaybah), Iraq
KQPD – COP Haditha, Iraq
KQRY – Ghazni, Afghanistan
KQSA – Bagram AB, Afghanistan
KQSE – Mosul North, Iraq
KQSL – COB Speicher (Al Sahra ), Iraq
KQSM – Misawa AB, Japan
KQSR – Sharan, Afghanistan
KQTA – NAF Atsugi, Japan
KQTI – Tal Afar, Iraq
KQTO – Joint Base Balad/LSA Anaconda, Iraq
KQTU – FOB Marez (Mosul), Iraq
KQTX – Kirkuk AB, Iraq
KQTZ – Baghdad Int'l , Iraq
KQVO – Al-Qa'im, Iraq
KQWM – Camp Buehring, Kuwait
KQXJ – Ali Air Base (Nasiriyah), Iraq
KQXN – Najaf, Iraq
KQYB – Faurei, Romania
KRAC – Batten Int'l  (John H. Batten ) – Racine, Wisconsin
KRAL – Riverside  – Riverside, California
KRAP – Rapid City  – Rapid City, South Dakota
KRAW – Warsaw  – Warsaw, Missouri
KRBD – Dallas Executive  – Dallas, Texas
KRBE – Rock County  – Bassett, Nebraska
KRBG – Roseburg (Major General Marion E. Carl Memorial Field) –R oseburg, Oregon
KRBL – Red Bluff  – Red Bluff, California
KRBM – Robinson Army  – Camp Robinson, Arkansas
KRBW – Lowcountry  – Walterboro, South Carolina
KRCA – Ellsworth Air Force Base – Rapid City, South Dakota
KRCE - Clarence E. Page  - Oklahoma City, Oklahoma
KRCM – SkyHaven  – Warrensburg, Missouri
KRCT – Nartron Field – Reed City, Michigan
KRDD – Redding  – Redding, California
KRDG – Reading  – Reading, Pennsylvania
KRDM – Roberts Field (Redmond ) – Redmond, Oregon
KRDR – Grand Forks Air Force Base – Grand Forks, North Dakota
KRDU – Raleigh-Durham Int'l – Raleigh, North Carolina
KRED – Red Lodge  – Red Lodge, Montana
KREI – Redlands  – Redlands, California
KREO – Rome State  – Rome, Oregon
KRGK – Red Wing  – Red Wing, Minnesota
KR

KRHP – Western Carolina  – Andrews, North Carolina
KRHV – Reid-Hillview  of Santa Clara County – San Jose, California
KRIC – Richmond Int'l  – Sandston, Virginia
KRID – Richmond  – Richmond, Indiana
KRIF – Richfield  – Richfield, Utah
KRIL – Garfield County  – Rifle, Colorado
KRIR – Flabob  – Riverside, California
KRIU – Rancho Murieta  – Rancho Murieta, California
KRIV – March Air Reserve Base – Riverside, California
KRIW – Riverton  – Riverton, Wyoming
KRJD – Ridgely Airpark – Ridgely, Maryland
KRKR - Robert S. Kerr  - Poteau, Oklahoma
KRKD – Knox County  – Rockland, Maine
KRKS – Rock Springs – Sweetwater County – Rock Springs, Wyoming
KRLD – Richland  – Richland, Washington
KRME – Griffiss Int'l  – Rome, New York
KRMN – Stafford  – Stafford, Virginia
KRND – Randolph Air Force Base – San Antonio, Texas
KRNM – Ramona  – Ramona, California
KRNO – Reno-Tahoe Int'l  – Reno, Nevada
KRNT – Renton  – Renton, Washington
KRNV – Cleveland  – Cleveland, Mississippi
KROA – Roanoke-Blacksburg (Woodrum Field) – Roanoke, Virginia
KROC – Greater Rochester Int'l – Rochester, New York
KROG – Rogers Executive  (Carter Field) – Rogers, Arkansas
KROW – Roswell Int'l Air Center – Roswell, New Mexico
KRPB – Belleville  – Belleville, Kansas
KRPD – Rice Lake  (Carl's Field) – Rice Lake, Wisconsin
KRPH – Graham  – Graham, Texas
KRPX – Roundup  – Roundup, Montana
KRQE – Window Rock  – Window Rock, Arizona
KRRT – Warroad Int'l Memorial (Swede Carlson Field) –W arroad, Minnesota
KRSL – Russell  – Russell, Kansas
KRST – Rochester Int'l  – Rochester, Minnesota
KRSW – Southwest Florida Int'l – Fort Myers, Florida
KRTN – Raton /Crews Field – Raton, New Mexico
KRTS - Reno Stead  - Reno, Nevada
KRUE – Russellville  – Russellville, Arkansas
KRUG – Rugby  – Rugby, North Dakota
KRUQ – Mid-Carolina  – Salisbury, North Carolina
KRUT – Rutland-Southern Vermont  – Rutland, Vermont
KRVL – Mifflin County  – Reedsville, Pennsylvania
KRVS – Richard Lloyd Jones Jr.  – Tulsa, Oklahoma
KRWI – Rocky Mount-Wilson – Rocky Mount, North Carolina
KRWL – Rawlins  – Rawlins, Wyoming
KRWV – Caldwell  – Caldwell, Texas
KRXE – Rexburg-Madison County  – Rexburg, Idaho
KRYN – Ryan Field – Tucson, Arizona
KRYV – Watertown  – Watertown, Wisconsin
KRYW – Lago Vista TX-Rusty Allen  – Lago Vista, Texas
KRYY – Cobb County Int'l-McCollum Field – Kennesaw, Georgia
KRZL – Jasper County  – Rensselaer, Indiana
KRZN – Burnett County  – Siren, Wisconsin
KRZT – Ross County  – Chillicothe, Ohio
KRZZ – Halifax County  – Roanoke Rapids, North Carolina
KSAA – Shively  – Saratoga, Wyoming
KSAC – Sacramento Executive  – Sacramento, California
KSAD (SAD) – Safford  – Safford, Arizona
KSAF – Santa Fe  – Santa Fe, New Mexico
KSAN – San Diego Int'l  (Lindbergh Field) – San Diego, California
KSAS – Salton Sea  – Salton City, California
KSAT – San Antonio Int'l  – San Antonio, Texas
KSAV – Savannah/Hilton Head Int'l – Savannah, Georgia
KSAW (MQT) - Sawyer Int'l  – Marquette, Michigan
KSAZ – Staples  – Staples, Minnesota
KSBA – Santa Barbara  – Santa Barbara, California
KSBD – San Bernardino Int'l – San Bernardino, California
KSBM – Sheboygan County Memorial  – Sheboygan, Wisconsin
KSBN – South Bend Int'l  – South Bend, Indiana
KSBP – San Luis Obispo County – San Luis Obispo, California
KSBS – Steamboat Springs  (Bob Adams Field) – Steamboat Springs, Colorado
KSBX – Shelby  – Shelby, Montana
KSBY – Salisbury-Ocean City Wicomico (SBY ) –S alisbury, Maryland
KSCB – Scribner State  – Scribner, Nebraska
KSCD – Sylacauga  (Merkel Field) – Sylacauga, Alabama
KSCH – Schenectady County  – Schenectady, New York
KSCK – Stockton Metropolitan  – Stockton, California
KSCR – Siler City  – [1] Siler City, North Carolina
KSDC – Williamson-Sodus  – Williamson/Sodus, New York
KSDF – Louisville Int'l  – Louisville, Kentucky
KSDL (SCF) – Scottsdale  – Scottsdale, Arizona
KSDM – Brown Field  – San Diego, California
KSDY – Sidney-Richland  – Sidney, Montana
KSEA – Seattle-Tacoma Int'l  – Seattle, Washington
KSEE – Gillespie Field – San Diego, California
KSEF – Sebring  – Sebring, Florida
KSEG – Penn Valley  – Selinsgrove, Pennsylvania
KSEM (SEM) – Craig Field – Selma, Alabama
KSEP – Stephenville Clark  – Stephenville, Texas
KSEZ (SDX) – Sedona  – Sedona, Arizona
KSFB – Orlando Sanford Int'l – Sanford, Florida
KSFD – Winner  (Bob Wiley Field) – Winner, South Dakota
KSFF – Felts Field – Spokane, Washington
KSFM – Sanford Seacoast  – Sanford, Maine
KSFO – San Francisco Int'l  – San Francisco, California
KSFQ – Suffolk Executive  – Suffolk, Virginia
KSFZ – North Central State  – Pawtucket, Rhode Island
KSGF – Springfield-Branson National – Springfield, Missouri
KSGJ – Northeast Florida  – St. Augustine, Florida
KSGT – Stuttgart  – Stuttgart, Arkansas
KSGU – St. George  – St. George, Utah (closed 2011)
KSGU – St. George  – St. George, Utah
KSHD – Shenandoah Valley  – Staunton, Virginia
KSHN – Sanderson Field – Shelton, Washington
KSHR – Sheridan County  – Sheridan, Wyoming
KSHV – Shreveport  – Shreveport, Louisiana
KSIF – Rockingham County NC Shiloh – Stoneville, North Carolina
KSIK – Sikeston Memorial – Sikeston, Missouri
KS

KSIY – Siskiyou County  – Montague, California
KSJC – Norman Y. Mineta San José Int'l – San Jose, California
KSJN (SJN) – St. Johns Industrial Air Park – St. Johns, Arizona
KSJT – San Angelo  (Mathis Field) – San Angelo, Texas
KSKA – Fairchild Air Force Base – Spokane, Washington
KSKF – Kelly Field Annex (formerly Kelly Air Force Base) – San Antonio, Texas
KSKI – Sac City  – Sac City, Iowa
KSKX – Taos  – Taos, New Mexico
KSLB – Storm Lake  – Storm Lake, Iowa
KSLC – Salt Lake City Int'l  – Salt Lake City, Utah
KSLE – McNary Field (Salem ) – Salem, Oregon
KSLG – Smith Field – Siloam Springs, Arkansas
KSLI – Los Alamitos Army  – Los Alamitos, California
KSLK – Adirondack  – Saranac Lake, New York
KSLN – Salina  – Salina, Kansas
KSLR – Sulphur Springs  – Sulphur Springs, Texas
KSMD – Smith Field – Fort Wayne, Indiana
KSME – Lake Cumberland  – Somerset, Kentucky
KSMF – Sacramento Int'l  – Sacramento, California
KSMN – Lemhi County  – Salmon, Idaho
KSMO – Santa Monica  (Clover Field) – Santa Monica, California
KSMQ – Somerset  (George Walker Field) – Somerville, New Jersey
KSMS – Sumter  – Sumter, South Carolina
KSMX – Santa Maria Public  (Capt. G. Allan Hancock Field) – Santa Maria, California
KSNA – John Wayne  – Santa Ana, California
KSNC – Chester  – Chester, Connecticut
KSNK - Winston Field - Snyder, Texas
KSNL – Shawnee  – Shawnee, Oklahoma
KSNS – Salinas  – Salinas, California
KSNT - Stanley  - Stanley, Idaho (airport is designated as 2U7 by FAA)
KSNY – Sidney  (Lloyd W. Carr Field) – Sidney, Nebraska
KSOA - Sonora  - Sonora, Texas
KSOP – Moore County  – Southern Pines, North Carolina
KSOW (SOW) – Show Low  – Show Low, Arizona
KSPA – Spartanburg Downtown Memorial – Spartanburg, South Carolina
KSPB – Scappoose Industrial Airpark – Scappoose, Oregon
KSPD – Springfield  – Springfield, Colorado
KSPF – Black Hills  (Clyde Ice Field) – Spearfish, South Dakota
KSPG – Albert Whitted  – St. Petersburg, Florida
KSPS – Wichita Falls  / Sheppard Air Force Base – Wichita Falls, Texas
KSPW – Spencer (Northwest Iowa ) –S pencer, Iowa
KSPX – Houston Gulf  – League City, Texas (closed 2002)
KSQL – San Carlos  – San Carlos, California
KSRC – Searcy  – Searcy, Arkansas
KSRQ – Sarasota-Bradenton Int'l – Sarasota, Florida
KSRR – Sierra Blanca  – Ruidoso, New Mexico
KSSC – Shaw Air Force Base – Sumter, South Carolina
KSSF – Stinson  – San Antonio, Texas
KSSN – Seneca Army  – Romulus, New York
KSSQ – Shell Lake  – Shell Lake, Wisconsin
KSTC – St. Cloud  – St. Cloud, Minnesota
KSTF – George M. Bryan  – Starkville, Mississippi
KSTK – Sterling  – Sterling, Colorado
KSTL – St. Louis Lambert Int'l – St. Louis, Missouri
KSTP – St. Paul Downtown  (Holman Field) – St. Paul, Minnesota
KSTS – Charles M. Schulz-Sonoma County – Santa Rosa, California
KSUA – Witham Field – Stuart, Florida
KSUN – Friedman Memorial  – Hailey, Idaho
KSUS – Spirit of St. Louis  – St. Louis, Missouri
KSUT – Cape Fear Regional Jetport (Howie Franklin Field) – Oak Island, North Carolina
KSUU – Travis Air Force Base – Fairfield, California
KSUW – Richard I. Bong  – Superior, Wisconsin
KSUX – Sioux Gateway  – Sioux City, Iowa
KSUZ – Saline County  – Benton, Arkansas
KSVC – Grant County  – Silver City, New Mexico
KSVE – Susanville  – Susanville, California
KSVH – Statesville  – Statesville, North Carolina
KSWF – Stewart Int'l  – Newburgh, New York
KSWI – Sherman  – Sherman, Texas
KSWO - Stillwater  - Stillwater, Oklahoma
KSWT – Seward  – Seward, Nebraska
KSWW – Avenger Field – Sweetwater, Texas
KSXL – Summersville  – Summersville, West Virginia
KSXT - Sexton Summit Weather Station - Grants Pass, Oregon (not an airport)
KSXU – Santa Rosa Route 66  – Santa Rosa, New Mexico
KSYF – Cheyenne County  – St. Francis, Kansas
KSYI – Shelbyville  (Bomar Field) – Shelbyville, Tennessee
KSYL – Roberts Army Heliport – Camp Roberts, San Luis Obispo County, California
KSYN – Stanton  – Stanton, Minnesota
KSYR – Syracuse Hancock Int'l – Syracuse, New York
KSZL – Whiteman Air Force Base – Johnson County, Missouri
KSZP – Santa Paula  – Santa Paula, California
KSZT – Sandpoint  (Dave Wall Field) – Sandpoint, Idaho
KTAD – Perry Stokes  – Trinidad, Colorado
KTAN – Taunton  – Taunton, Massachusetts
KTBX - Shoshoni  - Shoshoni, Wyoming
KTCC – Tucumcari  – Tucumcari, New Mexico
KTCL (TCL) – Tuscaloosa  – Tuscaloosa, Alabama
KTCM – McChord Air Force Base – Tacoma, Washington
KTCS – Truth or Consequences – Truth or Consequences, New Mexico
KTCY – Tracy  – Tracy, California
KTDF – Person County  – Roxboro, North Carolina
KTDO – Toledo-Winston Carlock Memorial – Toledo, Washington
KTEB (TEB) – Teterboro  – Teterboro, New Jersey
KTEL – Perry County  – Tell City, Indiana
KTEX – Telluride  – Telluride, Colorado
KTGI – Tangier Island  – Tangier, Virginia
KTHM – Thompson Falls  – Thompson Falls, Montana
KTHP – Hot Springs County – Thermopolis, Wyoming
KTHV – York  – York, Pennsylvania
KTIK – Tinker Air Force Base – Oklahoma City, Oklahoma
KTIW – Tacoma Narrows  – Tacoma, Washington
KTIX – Space Coast  – Titusville, Florida
KTKI – Collin County  at McKinney – McKinney, Texas
KTKO – Mankato  – Mankato, Kansas
KTLH – Tallahassee Int'l  – Tallahassee, Florida
KT

KTLR – Mefford  – Tulare, California
KTMB – Kendall-Tamiami Executive  – Miami, Florida
KTME – Houston Executive  – Waller County, Texas
KTMK - Tillamook  - Tillamook, Oregon
KTNP – Twentynine Palms  – Twentynine Palms, California
KTNT – Dade-Collier Training and Transition  – Miami, Florida
KTNU – Newton  – Newton, Iowa
KTNX – Tonopah Test Range  – Tonopah, Nevada
KTOA – Zamperini  – Torrance, California
KTOI (TOI) – Troy  – Troy, Alabama
KTOL – Toledo Express  – Toledo, Ohio
KTOP – Billard  – Topeka, Kansas
KTOR – Torrington  – Torrington, Wyoming
KTPA – Tampa Int'l  – Tampa, Florida
KTPF – Peter O. Knight  – Davis Island, Tampa, Florida
KTPH – Tonopah  – Tonopah, Nevada
KTPL – Draughon-Miller Central Texas  – Temple, Texas
KTQE – Tekamah  – Tekamah, Nebraska
KTQH - Tahlequah  - Tahlequah, Oklahoma
KTQK – Scott City  – Scott City, Nebraska
KTRI – Tri-Cities  – Blountville, Tennessee
KTRK – Truckee-Tahoe  – Truckee, California
KTRM – Jacqueline Cochran – Thermal, California
KTRX – Trenton  – Trenton, Missouri
KTSP – Tehachapi  – Tehachapi, California
KTTA – Sanford-Lee County – Sanford, North Carolina
KTTD – Troutdale  – Portland, Oregon
KTTF – Custer  – Monroe, Michigan
KTTN – Trenton-Mercer  – Trenton, New Jersey
KTUL (TUL) – Tulsa Int'l  – Tulsa, Oklahoma
KTUP – Tupelo  – Tupelo, Mississippi
KTUS (TUS) – Tucson Int'l  – Tucson, Arizona
KTVC – Cherry Capital  – Traverse City, Michigan
KTVL – Lake Tahoe  – South Lake Tahoe, California
KTVR – Vicksburg – Tallulah  – Tallulah, Louisiana
KTVY – Tooele Valley  (Bolinder Field) – Tooele, Utah
KTWF – Magic Valley  (Joslin Field) – Twin Falls, Idaho
KTWT – Sturgis  – Sturgis, Kentucky
KTXK – Texarkana -Webb Field – Texarkana, Arkansas
KTYL (TYZ) – Taylor  – Taylor, Arizona
KTYQ – Indianapolis Executive  – Indianapolis, Indiana
KTYR – Tyler Pounds  – Tyler, Texas
KTYS – McGhee Tyson  – Knoxville, Tennessee
KTZR – Bolton Field – Columbus, Ohio
KTZT – Belle Plaine  – Belle Plaine, Iowa
KUAO – Aurora State  – Aurora, Oregon
KUBE – Cumberland  – Cumberland, Wisconsin
KUBS – Columbus-Lowndes County  – Columbus, Mississippi
KUCA – Oneida County  – Utica, New York
KUCP – New Castle  – New Castle, Pennsylvania
KUDD – Bermuda Dunes  – Palm Springs, California
KUDG – Darlington County Jetport – Darlington, South Carolina
KUES – Waukesha County  (Crites Field) – Waukesha, Wisconsin
KUGN – Waukegan  – Waukegan, Illinois
KUIL – Quillayute  – Quillayute, Washington
KUIN – Quincy  – Quincy, Illinois
KUKF – Wilkes County  – North Wilkesboro, North Carolina
KUKI – Ukiah  – Ukiah, California
KUKL – Coffey County  – Burlington, Kansas
KUKT – Quakertown  – Quakertown, Pennsylvania
KULS – Ulysses  – Ulysses, Kansas
KUMP – Indianapolis Metropolitan  – Fishers, Indiana
KUNI – Gordon K. Bush  – Athens / Albany, Ohio
KUNU – Dodge County  – Juneau, Wisconsin
KUNV – University Park  – University Park, Pennsylvania
KUOS – Franklin County  – Sewanee, Tennessee
KUOX – University-Oxford  – Oxford, Mississippi
KUTS – Huntsville  – Huntsville, Texas
KUUU – Newport State  – Newport, Rhode Island
KUVA – Garner Field – Uvalde, Texas
KUZA – Rock Hill/York County  (Bryant Field) – Rock Hill, South Carolina
KVAY – South Jersey  – Mount Holly, New Jersey
KVBG – Vandenberg Air Force Base – Lompoc, California
KVBT – Bentonville  – Bentonville, Arkansas
KVBW – Bridgewater  – Bridgewater, Virginia
KVCB – Nut Tree  – Vacaville, California
KVCT – Victoria  – Victoria, Texas
KVCV – Southern California Logistics – Victorville, California
KVDF – Tampa Executive  – Tampa, Florida
KVEL – Vernal-Uintah County  – Vernal, Utah
KVER – Jesse Viertel Memorial  – Boonville, Missouri
KVES – Darke County  – Versailles, Ohio
KVGT – North Las Vegas  – Las Vegas, Nevada
KVIH – Rolla National  – Rolla / Vichy, Missouri
KVIS – Visalia  – Visalia, California
KVJI – Virginia Highlands  – Abingdon, Virginia
KVKS – Vicksburg  – Vicksburg, Mississippi
KVKX – Potomac  – Friendly, Maryland
KVLD – Valdosta  – Valdosta, Georgia
KVLL – Oakland-Troy  – Troy, Michigan
KVMR – Davidson  – Vermillion, South Dakota
KVNC – Venice  – Venice, Florida
KVNY (VNY) – Van Nuys  – Van Nuys, California
KVPS – Destin-Fort Walton Beach  / Eglin Air Force Base – Valparaiso, Florida
KVPZ – Porter County  – Valparaiso, Indiana
KVQQ (VQQ) – Cecil Field – Jacksonville, Florida
KVRB – Vero Beach  – Vero Beach, Florida
KVSF – Hartness State  – Springfield, Vermont
KVTA – Newark-Heath  – Newark, Ohio
KVTN – Miller Field – Valentine, Nebraska
KVUJ – Stanly County  – Albemarle, North Carolina
KVUO – Pearson Field – Vancouver, Washington
KVVS – Joseph A. Hardy Connellsville – Connellsville, Pennsylvania
KVYS – Illinois Valley  (Walter A. Duncan Field) – Peru, Illinois
KWAL – Wallops Flight Facility – Wallops Island, Virginia
KWAY – Greene County  – Waynesburg, Pennsylvania
KWBW – Wilkes-Barre Wyoming Valley  – Wilkes-Barre, Pennsylvania
KWDG - Woodring  - Enid, Oklahoma
KWHP – Whiteman  – Los Angeles, California
KWJF – General William J. Fox  – Lancaster, California
KWLD – Strother Field – Winfield, Kansas
KWLW – Willows-Glenn County  – Willows, California
KWMC – Winnemucca  – Winnemucca, Nevada
KWRB – Robins Air Force Base – Warner Robins, Georgia
KWRI – McGuire Air Force Base – Wrightstown, New Jersey
KWRL – Worland  – Worland, Wyoming
KWST – Westerly State  – Westerly, Rhode Island
KWVI – Watsonville  – Watsonville, California
KWVL – Waterville Robert LaFleur  – Waterville, Maine
KWWD – Cape May  – Wildwood, New Jersey
KWWR - West Woodward  - Woodward, Oklahoma
KWYS – Yellowstone  – West Yellowstone, Montana
KXBP – Bridgeport  – Bridgeport, Texas
KXFL – Flagler County  – Bunnell, Florida
KXLL – Allentown Queen City – Allentown, Pennsylvania
KXMR – Cape Canaveral Air Force Station Skid Strip – Cocoa Beach, Florida
KXNA – Northwest Arkansas – Fayetteville / Springdale, Arkansas
KXNO – North Air Force Auxiliary Field – North, South Carolina
KXNX – Sumner County  – Gallatin, Tennessee
KXTA – Nellis Bombing Range Test Site (Area 51) – Groom Lake, Nevada
KXVG – Longville  – Longville, Minnesota
KYIP (YIP) – Willow Run  – Detroit, Michigan
KYKM (YKM) – Yakima Air Terminal (McAllister Field) – Yakima, Washington
KYKN (YKN) – Chan Gurney  – Yankton, South Dakota
KYNG (YNG) – Youngstown-Warren  – Youngstown / Warren, Ohio
KZEF – Elkin  – Elkin, North Carolina
KZER – Schuylkill County  (Joe Zerbey Field) – Pottsville, Pennsylvania
KZPH (ZPH) – Zephyrhills  – Zephyrhills, Florida
KZUN – Black Rock  – Zuni Pueblo, New Mexico
KZZV (ZZV) – Zanesville  – Zanesville, Ohio
